rxns	newEqn
HMR_7254	16 isopentenyl-pPP[c] + trans,trans,cis-geranyl-geranyl-pp[c] => dehydrodolichol-diphosphate[c] + 16 PPi[c]
HMR_7256	dolichyl-diphosphate[c] + H2O[c] => dolichyl-phosphate[c] + Pi[c] + H+[c]
HMR_7258	dehydrodolichol-diphosphate[c] + H2O[c] => dehydrodolichol-phosphate[c] + Pi[c] + H+[c]
HMR_7263	CTP[c] + dolichol[c] => CDP[c] + dolichyl-phosphate[c] + H+[c]
HMR_7265	N-acetyl-D-glucosaminyldiphosphodolichol[c] + UDP-N-acetylglucosamine[c] => N,N-chitobiosyldiphosphodolichol[c] + UDP[c] + H+[c]
HMR_7266	GDP-mannose[c] + N,N-chitobiosyldiphosphodolichol[c] => beta-D-mannosyldiacetylchitobiosyldiphosphodolichol[c] + GDP[c] + H+[c]
HMR_7267	beta-D-mannosyldiacetylchitobiosyldiphosphodolichol[c] + GDP-mannose[c] => alpha-D-mannosyl-beta-D-mannosyl-diacetylchitobiosyldiphosphodolichol[c] + GDP[c] + H+[c]
HMR_7268	alpha-D-mannosyl-beta-D-mannosyl-diacetylchitobiosyldiphosphodolichol[c] + GDP-mannose[c] => G00005[c] + GDP[c] + H+[c]
HMR_7269	G00005[c] + GDP-mannose[c] => G10526[c] + GDP[c] + H+[c]
HMR_7270	G10526[c] + GDP-mannose[c] => G00006[c] + GDP[c] + H+[c]
HMR_7274	dolichyl-phosphate-D-mannose[r] + G00006[r] => dolichyl-phosphate[r] + G10595[r] + H+[r]
HMR_7275	dolichyl-phosphate-D-mannose[r] + G10595[r] => dolichyl-phosphate[r] + G10596[r] + H+[r]
HMR_7276	dolichyl-phosphate-D-mannose[r] + G10596[r] => dolichyl-phosphate[r] + G10597[r] + H+[r]
HMR_7277	dolichyl-phosphate-D-mannose[r] + G10597[r] => dolichyl-phosphate[r] + G00007[r] + H+[r]
HMR_7279	dolichyl-D-glucosyl-phosphate[r] + G00007[r] => dolichyl-phosphate[r] + G10598[r] + H+[r]
HMR_7280	dolichyl-D-glucosyl-phosphate[r] + G10598[r] => dolichyl-phosphate[r] + G10599[r] + H+[r]
HMR_7281	dolichyl-D-glucosyl-phosphate[r] + G10599[r] => (Glc)3 (GlcNAc)2 (Man)9 (PP-Dol)1[r] + dolichyl-phosphate[r] + H+[r]
HMR_7285	(Glc)3 (GlcNAc)2 (Man)9 (PP-Dol)1[r] + [protein]-L-asparagine[r] => (alpha-D-Glucosyl)3-(alpha-D-mannosyl)8-beta-D-mannosyl-diacetylchitobiosyl-L-asparagine (protein)[r] + dolichyl-diphosphate[r] + H+[r]
HMR_8692	dolichyl-D-glucosyl-phosphate[r] + H2O[r] => dolichyl-phosphate[r] + glucose[r] + H+[r]
HMR_8378	dolichyl-phosphate[c] + O-D-mannosylprotein[c] + H+[c] <=> [protein]-L-serine[c] + dolichyl-phosphate-D-mannose[c]
BDMT_L	GDP-mannose[c] + N,N-chitobiosyldiphosphodolichol[c] => beta-D-mannosyldiacetylchitobiosyldiphosphodolichol[c] + GDP[c] + H+[c]
BDMT_U	GDP-mannose[c] + N,N-Diacetylchitobiosyldiphosphodolichol, Human Uterine Homolog[c] => GDP[c] + H+[c] + Beta-D-Mannosyldiacetylchitobiosyldiphosphodolichol, Human Uterine Homolog[c]
BMTer_U	memgacpail heparan sulfate[r] + Dolichyl Phosphate D-Mannose, Human Uterine Homolog[r] => H+[r] + m2emgacpail heparan sulfate[r] + Dolichyl Phosphate[r]
DEDOLP1_L	dehydrodolichol-diphosphate[c] + H2O[c] => dehydrodolichol-phosphate[c] + H+[c] + Pi[c]
DEDOLP1_U	H2O[c] + Dehydrodolichol Diphosphate, Human Uterine Homolog[c] => H+[c] + Pi[c] + Dehydrodolichol Phosphate, Human Uterine Homolog[c]
DEDOLP2_L	dehydrodolichol-phosphate[c] + H2O[c] => dehydrodolichol[c] + Pi[c]
DEDOLP2_U	H2O[c] + Dehydrodolichol Phosphate, Human Uterine Homolog[c] => Pi[c] + Dehydrodolichol, Human Uterine Homolog[c]
DEDOLR_L	dehydrodolichol[c] + H+[c] + NADPH[c] => dolichol[c] + NADP+[c]
DEDOLR_U	H+[c] + NADPH[c] + Dehydrodolichol, Human Uterine Homolog[c] => NADP+[c] + Dolichol, Human Uterine Homolog[c]
DOLASNT_Ler	(Glc)3 (GlcNAc)2 (Man)9 (PP-Dol)1[r] + [protein]-L-asparagine[r] => (alpha-D-Glucosyl)3-(alpha-D-mannosyl)8-beta-D-mannosyl-diacetylchitobiosyl-L-asparagine (protein)[r] + dolichyl-diphosphate[r] + H+[r]
DOLASNT_Uer	[protein]-L-asparagine[r] + (Alpha-D-Glucosyl)3-(Alpha-D-Mannosyl)8-Beta-D-Mannosyl-Diacetylchitobiosyldiphosphodolichol, Human Uterine Homolog[r] => (alpha-D-Glucosyl)3-(alpha-D-mannosyl)8-beta-D-mannosyl-diacetylchitobiosyl-L-asparagine (protein)[r] + H+[r] + Dolichol Diphosphate, Human Uterine Homolog[r]
DOLDPP_Uer	H2O[r] + Dolichol Diphosphate, Human Uterine Homolog[r] => H+[r] + Pi[r] + Dolichyl Phosphate[r]
DOLGLCP_Lter	dolichyl-D-glucosyl-phosphate[c] => dolichyl-D-glucosyl-phosphate[r]
DOLGLCP_Uter	Dolichyl Beta-D-Glucosyl Phosphate, Human Uterine Homolog[c] => Dolichyl Beta-D-Glucosyl Phosphate, Human Uterine Homolog[r]
DOLGPP_Ler	dolichyl-D-glucosyl-phosphate[r] + H2O[r] => dolichyl-phosphate[r] + glucose[r] + H+[r]
DOLGPP_Uer	H2O[r] + Dolichyl Beta-D-Glucosyl Phosphate, Human Uterine Homolog[r] => glucose[r] + H+[r] + Dolichyl Phosphate[r]
DOLICHOL_Lter	dolichol[r] => dolichol[c]
DOLICHOL_Uter	Dolichol, Human Uterine Homolog[r] <=> Dolichol, Human Uterine Homolog[c]
DOLK_L	CTP[c] + dolichol[c] => CDP[c] + dolichyl-phosphate[c] + H+[c]
DOLK_U	CTP[c] + Dolichol, Human Uterine Homolog[c] => CDP[c] + H+[c] + Dolichyl Phosphate[c]
DOLMANP_Lter	dolichyl-phosphate-D-mannose[c] => dolichyl-phosphate-D-mannose[r]
DOLMANP_Uter	Dolichyl Phosphate D-Mannose, Human Uterine Homolog[c] => Dolichyl Phosphate D-Mannose, Human Uterine Homolog[r]
DOLP_Lter	dolichyl-D-glucosyl-phosphate[r] + (Alpha-D-Mannosyl)8-Beta-D-Mannosyl-Diacetylchitobiosyldiphosphodolichol, Human Liver Homolog[r] => dolichyl-phosphate[r] + G10598[r] + H+[r]
DOLP_Uter	Dolichyl Beta-D-Glucosyl Phosphate, Human Uterine Homolog[r] + (Alpha-D-Mannosyl)8-Beta-D-Mannosyl-Diacetylchitobiosyldiphosphodolichol, Human Uterine Homolog[r] => H+[r] + Dolichyl Phosphate[r] + Alpha-D-Glucosyl-(Alpha-D-Mannosyl)8-Beta-D-Mannosyl-Diacetylchitobiosyldiphosphodolichol, Human Uterine Homolog[r]
DOLPGT1_Ler	dolichyl-D-glucosyl-phosphate[r] + G10598[r] => dolichyl-phosphate[r] + G10599[r] + H+[r]
DOLPGT1_Uer	Dolichyl Beta-D-Glucosyl Phosphate, Human Uterine Homolog[r] + Alpha-D-Glucosyl-(Alpha-D-Mannosyl)8-Beta-D-Mannosyl-Diacetylchitobiosyldiphosphodolichol, Human Uterine Homolog[r] => H+[r] + Dolichyl Phosphate[r] + (Alpha-D-Glucosyl)2-(Alpha-D-Mannosyl)8-Beta-D-Mannosyl-Diacetylchitobiosyldiphosphodolichol, Human Uterine Homolog[r]
DOLPGT2_Ler	dolichyl-D-glucosyl-phosphate[r] + G10599[r] => (Glc)3 (GlcNAc)2 (Man)9 (PP-Dol)1[r] + dolichyl-phosphate[r] + H+[r]
DOLPGT2_Uer	Dolichyl Beta-D-Glucosyl Phosphate, Human Uterine Homolog[r] + (Alpha-D-Glucosyl)2-(Alpha-D-Mannosyl)8-Beta-D-Mannosyl-Diacetylchitobiosyldiphosphodolichol, Human Uterine Homolog[r] => H+[r] + Dolichyl Phosphate[r] + (Alpha-D-Glucosyl)3-(Alpha-D-Mannosyl)8-Beta-D-Mannosyl-Diacetylchitobiosyldiphosphodolichol, Human Uterine Homolog[r]
DOLPGT3_Uer	H2O[r] + Dolichyl Phosphate[r] => Pi[r] + Dolichol, Human Uterine Homolog[r]
DOLPH_Ler	dolichyl-phosphate-D-mannose[r] + G00006[r] => dolichyl-phosphate[r] + H+[r] + (Alpha-D-Mannosyl)5-Beta-D-Mannosyl-Diacetylchitobiosyldiphosphodolichol, Human Liver Homolog[r]
DOLPH_Uer	Dolichyl Phosphate D-Mannose, Human Uterine Homolog[r] + (Alpha-D-Mannosyl)4-Beta-D-Mannosyl-Diacetylchitobiosyldiphosphodolichol, Human Uterine Homolog[r] => H+[r] + Dolichyl Phosphate[r] + (Alpha-D-Mannosyl)5-Beta-D-Mannosyl-Diacetylchitobiosyldiphosphodolichol, Human Uterine Homolog[r]
DOLPMT_L	dolichyl-phosphate-D-mannose[r] + (Alpha-D-Mannosyl)5-Beta-D-Mannosyl-Diacetylchitobiosyldiphosphodolichol, Human Liver Homolog[r] => dolichyl-phosphate[r] + H+[r] + (Alpha-D-Mannosyl)6-Beta-D-Mannosyl-Diacetylchitobiosyldiphosphodolichol, Human Liver Homolog[r]
DOLPMT_U	Dolichyl Phosphate D-Mannose, Human Uterine Homolog[r] + (Alpha-D-Mannosyl)5-Beta-D-Mannosyl-Diacetylchitobiosyldiphosphodolichol, Human Uterine Homolog[r] => H+[r] + Dolichyl Phosphate[r] + (Alpha-D-Mannosyl)6-Beta-D-Mannosyl-Diacetylchitobiosyldiphosphodolichol, Human Uterine Homolog[r]
DOLPMT1_Ler	dolichyl-phosphate-D-mannose[r] + (Alpha-D-Mannosyl)6-Beta-D-Mannosyl-Diacetylchitobiosyldiphosphodolichol, Human Liver Homolog[r] => dolichyl-phosphate[r] + H+[r] + (Alpha-D-Mannosyl)7-Beta-D-Mannosyl-Diacetylchitobiosyldiphosphodolichol, Human Liver Homolog[r]
DOLPMT1_Uer	Dolichyl Phosphate D-Mannose, Human Uterine Homolog[r] + (Alpha-D-Mannosyl)6-Beta-D-Mannosyl-Diacetylchitobiosyldiphosphodolichol, Human Uterine Homolog[r] => H+[r] + Dolichyl Phosphate[r] + (Alpha-D-Mannosyl)7-Beta-D-Mannosyl-Diacetylchitobiosyldiphosphodolichol, Human Uterine Homolog[r]
DOLPMT2_Ler	dolichyl-phosphate-D-mannose[r] + (Alpha-D-Mannosyl)7-Beta-D-Mannosyl-Diacetylchitobiosyldiphosphodolichol, Human Liver Homolog[r] => dolichyl-phosphate[r] + H+[r] + (Alpha-D-Mannosyl)8-Beta-D-Mannosyl-Diacetylchitobiosyldiphosphodolichol, Human Liver Homolog[r]
DOLPMT2_Uer	Dolichyl Phosphate D-Mannose, Human Uterine Homolog[r] + (Alpha-D-Mannosyl)7-Beta-D-Mannosyl-Diacetylchitobiosyldiphosphodolichol, Human Uterine Homolog[r] => H+[r] + Dolichyl Phosphate[r] + (Alpha-D-Mannosyl)8-Beta-D-Mannosyl-Diacetylchitobiosyldiphosphodolichol, Human Uterine Homolog[r]
DOLPMT3_Ler	dolichyl-phosphate[c] + GDP-mannose[c] => dolichyl-phosphate-D-mannose[c] + GDP[c]
DOLPMT4_Ler	dolichyl-phosphate[r] => dolichyl-phosphate[c]
DOLPMT4_Uer	Dolichyl Phosphate[r] => Dolichyl Phosphate[c]
G12MT1_L	GDP-mannose[c] + (Alpha-D-Mannosyl)2-Beta-D-Mannosyl-Diacetylchitobiosyldiphosphodolichol, Human Liver Homolog[c] => GDP[c] + H+[c] + (Alpha-D-Mannosyl)3-Beta-D-Mannosyl-Diacetylchitodiphosphodolichol, Human Liver Homolog[c]
G12MT1_U	GDP-mannose[c] + (Alpha-D-Mannosyl)2-Beta-D-Mannosyl-Diacetylchitobiosyldiphosphodolichol, Human Uterine Homolog[c] => GDP[c] + H+[c] + (Alpha-D-Mannosyl)3-Beta-D-Mannosyl-Diacetylchitodiphosphodolichol, Human Uterine Homolog[c]
G12MT2_L	GDP-mannose[c] + (Alpha-D-Mannosyl)3-Beta-D-Mannosyl-Diacetylchitodiphosphodolichol, Human Liver Homolog[c] => G00006[c] + GDP[c] + H+[c]
G12MT2_U	GDP-mannose[c] + (Alpha-D-Mannosyl)3-Beta-D-Mannosyl-Diacetylchitodiphosphodolichol, Human Uterine Homolog[c] => GDP[c] + H+[c] + (Alpha-D-Mannosyl)4-Beta-D-Mannosyl-Diacetylchitobiosyldiphosphodolichol, Human Uterine Homolog[c]
G13MT_L	beta-D-mannosyldiacetylchitobiosyldiphosphodolichol[c] + GDP-mannose[c] => alpha-D-mannosyl-beta-D-mannosyl-diacetylchitobiosyldiphosphodolichol[c] + GDP[c] + H+[c]
G13MT_U	GDP-mannose[c] + Beta-D-Mannosyldiacetylchitobiosyldiphosphodolichol, Human Uterine Homolog[c] => GDP[c] + H+[c] + Alpha-D-Mannosyl-Beta-D-Mannosyl-Diacylchitobiosyldiphosphodolichol, Human Uterine Homolog[c]
G16MT_L	alpha-D-mannosyl-beta-D-mannosyl-diacetylchitobiosyldiphosphodolichol[c] + GDP-mannose[c] => GDP[c] + H+[c] + (Alpha-D-Mannosyl)2-Beta-D-Mannosyl-Diacetylchitobiosyldiphosphodolichol, Human Liver Homolog[c]
G16MT_U	GDP-mannose[c] + Alpha-D-Mannosyl-Beta-D-Mannosyl-Diacylchitobiosyldiphosphodolichol, Human Uterine Homolog[c] => GDP[c] + H+[c] + (Alpha-D-Mannosyl)2-Beta-D-Mannosyl-Diacetylchitobiosyldiphosphodolichol, Human Uterine Homolog[c]
GGT_U	16 isopentenyl-pPP[c] + Trans,Trans,Cis-Geranylgeranyl Diphosphate[c] => 16 PPi[c] + Dehydrodolichol Diphosphate, Human Uterine Homolog[c]
GLCNACPT_L	dolichyl-phosphate[c] + UDP-N-acetylglucosamine[c] => N-acetyl-D-glucosaminyldiphosphodolichol[c] + UMP[c]
GLCNACPT_U	UDP-N-acetylglucosamine[c] + Dolichyl Phosphate[c] => UMP[c] + N-Acetyl-D-Glucosaminyldiphosphodolichol, Human Uterine Homolog[c]
GLCNACT_L	N-acetyl-D-glucosaminyldiphosphodolichol[c] + UDP-N-acetylglucosamine[c] => H+[c] + N,N-chitobiosyldiphosphodolichol[c] + UDP[c]
GLCNACT_U	UDP-N-acetylglucosamine[c] + N-Acetyl-D-Glucosaminyldiphosphodolichol, Human Uterine Homolog[c] => H+[c] + UDP[c] + N,N-Diacetylchitobiosyldiphosphodolichol, Human Uterine Homolog[c]
GPIMTer_U	glucosaminyl-acylphosphatidylinositol[r] + Dolichyl Phosphate D-Mannose, Human Uterine Homolog[r] => H+[r] + mgacpail heparan sulfate[r] + Dolichyl Phosphate[r]
H2MTer_U	mgacpail heparan sulfate[r] + Dolichyl Phosphate D-Mannose, Human Uterine Homolog[r] => H+[r] + m2gacpail heparan sulfate[r] + Dolichyl Phosphate[r]
H3MTer_U	m2gacpail heparan sulfate[r] + Dolichyl Phosphate D-Mannose, Human Uterine Homolog[r] => H+[r] + m3gacpail heparan sulfate[r] + Dolichyl Phosphate[r]
H5MTer_U	emgacpail heparan sulfate[r] + Dolichyl Phosphate D-Mannose, Human Uterine Homolog[r] => H+[r] + memgacpail heparan sulfate[r] + Dolichyl Phosphate[r]
H6MTer_U	m2emgacpail heparan sulfate[r] + Dolichyl Phosphate D-Mannose, Human Uterine Homolog[r] => H+[r] + m3emgacpail heparan sulfate[r] + Dolichyl Phosphate[r]
H7MTer_U	em2emgacpail heparan sulfate[r] + Dolichyl Phosphate D-Mannose, Human Uterine Homolog[r] => H+[r] + mem2emgacpail heparan sulfate[r] + Dolichyl Phosphate[r]
UDPDOLPT_U	UDP-glucose[c] + Dolichyl Phosphate[c] => UDP[c] + Dolichyl Beta-D-Glucosyl Phosphate, Human Uterine Homolog[c]
DOLDPP_Ler	dolichyl-diphosphate[r] + H2O[r] => dolichyl-phosphate[r] + H+[r] + Pi[r]
DOLPGT3_Ler	dolichyl-phosphate[r] + H2O[r] => dolichol[r] + Pi[r]
DOLPMT3_Uer	GDP-mannose[c] + Dolichyl Phosphate[c] => GDP[c] + Dolichyl Phosphate D-Mannose, Human Uterine Homolog[c]
GPIMTer_L	dolichyl-phosphate-D-mannose[r] + glucosaminyl-acylphosphatidylinositol[r] => dolichyl-phosphate[r] + H+[r] + mgacpail heparan sulfate[r]
HMR_4498	[ACP][c] + H2O[c] => apo-[ACP][c] + phosphopantetheine[c] + H+[c]
HMR_4499	mitoApo-[ACP][m] + phosphopantetheine[m] + H+[m] => H2O[m] + mitoACP[m]
HMR_9520	SAH[c] + tRNA containing N7-methylguanine[c] <=> SAM[c] + tRNA-guanine[c]
HMR_7180	Tn-antigen[g] + UDP-N-acetylglucosamine[g] => G00031[g] + UDP[g] + H+[g]
HMR_7181	G00031[g] + UDP-galactose[g] => G00032[g] + UDP[g] + H+[g]
HMR_0865	lc4Cer[c] + UDP-galactose[c] => G00038[c] + UDP[c] + H+[c]
HMR_0866	G00038[c] + GDP-L-fucose[c] => GDP[c] + type I B glycolipid[c] + H+[c]
HMR_0871	GDP-L-fucose[c] + IV2Fuc-Lc4Cer[c] => GDP[c] + IV2Fuc,III4Fuc-Lc4Cer[c] + H+[c]
HMR_0880	GDP-L-fucose[c] + nLc5Cer(G00051)[c] => GDP[c] + type II B antigen[c] + H+[c]
HMR_0881	IV2Fuc-nLc4Cer[c] + UDP-galactose[c] => type II B antigen[c] + UDP[c] + H+[c]
HMR_0882	GDP-L-fucose[c] + IV2Fuc-nLc4Cer[c] => GDP[c] + III3,IV2Fuc-nLc4Cer[c] + H+[c]
HMR_0883	GDP-L-fucose[c] + paragloboside[c] => GDP[c] + IV2Fuc-nLc4Cer[c] + H+[c]
HMR_0884	IV2Fuc-nLc4Cer[c] + UDP-N-acetyl-D-galactosamine[c] => type II A antigen[c] + UDP[c] + H+[c]
HMR_0885	type II A antigen[c] + UDP-galactose[c] => G00057[c] + UDP[c] + H+[c]
HMR_0886	G00057[c] + GDP-L-fucose[c] => GDP[c] + type III H glycolipid[c] + H+[c]
HMR_0888	GDP-L-fucose[c] + paragloboside[c] => GDP[c] + III3Fuc-nLc4Cer[c] + H+[c]
HMR_0893	GDP-L-fucose[c] + nLc8Cer[c] => G00084[c] + GDP[c] + H+[c]
HMR_0894	G00084[c] + GDP-L-fucose[c] => G00085[c] + GDP[c] + H+[c]
HMR_0895	G00085[c] + GDP-L-fucose[c] => G00086[c] + GDP[c] + H+[c]
HMR_0899	GDP-L-fucose[c] + VI2Fuc-nLc6[c] => G00081[c] + GDP[c] + H+[c]
HMR_0900	G00081[c] + GDP-L-fucose[c] => G00082[c] + GDP[c] + H+[c]
HMR_0902	UDP-N-acetyl-D-galactosamine[c] + VI2Fuc-nLc6[c] => G00072[c] + UDP[c] + H+[c]
HMR_0903	G00072[c] + UDP-galactose[c] => G00073[c] + UDP[c] + H+[c]
HMR_0904	G00073[c] + GDP-L-fucose[c] => G00074[c] + GDP[c] + H+[c]
HMR_0905	G00074[c] + UDP-N-acetyl-D-galactosamine[c] => type IIIAb[c] + UDP[c] + H+[c]
HMR_0907	G00077[c] + UDP-galactose[c] => iso-nLc8Cer[c] + UDP[c] + H+[c]
HMR_0908	GDP-L-fucose[c] + iso-nLc8Cer[c] => GDP[c] + monofucosyllactoisooctaosylceramide[c] + H+[c]
HMR_0909	GDP-L-fucose[c] + monofucosyllactoisooctaosylceramide[c] => G00079[c] + GDP[c] + H+[c]
HMR_8285	acgalfuc12gal14acglcgalgluside heparan sulfate[g] + UDP-galactose[g] => galacgalfuc12gal14acglcgalgluside heparan sulfate[g] + UDP[g] + H+[g]
HMR_8286	galacgalfuc12gal14acglcgalgluside heparan sulfate[g] + GDP-L-fucose[g] => GDP[g] + type III H glycolipid[g] + H+[g]
HMR_8292	UDP-N-acetyl-D-galactosamine[g] + VI2Fuc-nLc6[g] => acgalfucgalacglcgal14acglcgalgluside heparan sulfate[g] + UDP[g] + H+[g]
HMR_8293	acgalfucgalacglcgal14acglcgalgluside heparan sulfate[g] + UDP-galactose[g] => galacgalfucgalacglcgal14acglcgalgluside heparan sulfate[g] + UDP[g] + H+[g]
HMR_8294	galacgalfucgalacglcgal14acglcgalgluside heparan sulfate[g] + GDP-L-fucose[g] => fucgalacgalfucgalacglcgal14acglcgalgluside heparan sulfate[g] + GDP[g] + H+[g]
HMR_8295	fucgalacgalfucgalacglcgal14acglcgalgluside heparan sulfate[g] + UDP-N-acetyl-D-galactosamine[g] => type IIIAb[g] + UDP[g] + H+[g]
HMR_8307	GDP-L-fucose[g] + nLc8Cer[g] => fucgalacglc13galacglcgal14acglcgalgluside heparan sulfate[g] + GDP[g] + H+[g]
HMR_8308	fucgalacglc13galacglcgal14acglcgalgluside heparan sulfate[g] + GDP-L-fucose[g] => fucfucgalacglc13galacglcgal14acglcgalgluside heparan sulfate[g] + GDP[g] + H+[g]
HMR_8317	G00077[g] + UDP-galactose[g] => iso-nLc8Cer[c] + UDP[g] + H+[c]
HMR_8318	CMP-N-acetylneuraminate[g] + lc4Cer[g] => acngalacglcgalgluside heparan sulfate[g] + CMP[g] + H+[g]
HMR_8319	acngalacglcgalgluside heparan sulfate[g] + GDP-L-fucose[g] => GDP[g] + H+[g] + IV3Neu5Ac,III4Fuc-Lc4Cer[g]
HMR_8330	GDP-L-fucose[g] + VI2Fuc-nLc6[g] => fucfucgalacglcgal14acglcgalgluside heparan sulfate[g] + GDP[g] + H+[g]
HMR_8331	fucfucgalacglcgal14acglcgalgluside heparan sulfate[g] + GDP-L-fucose[g] => fucfucfucgalacglcgal14acglcgalgluside heparan sulfate[g] + GDP[g] + H+[g]
FUT32g	acngalacglcgalgluside heparan sulfate[g] + GDP-L-fucose[g] => GDP[g] + H+[g] + IV3Neu5Ac,III4Fuc-Lc4Cer[g]
HMR_5381	PAPS[c] + thioredoxin[c] => oxidized thioredoxin[c] + PAP[c] + sulfite[c] + 2 H+[c]
HMR_5167	315 ATP[c] + 5 glycyl-tRNA(gly)[c] + 316 H2O[c] + 8 L-alanyl-tRNA(ala)[c] + 3 L-asparaginyl-tRNA(asn)[c] + 7 L-aspartyl-tRNA(asp)[c] + 5 L-cysteinyl-tRNA(cys)[c] + 5 L-glutaminyl-tRNA(gln)[c] + 10 L-glutamyl-tRNA(glu)[c] + L-histidyl-tRNA(his)[c] + 4 L-isoleucyl-tRNA(ile)[c] + 6 L-leucyl-tRNA(leu)[c] + 12 L-lysyl-tRNA(lys)[c] + 3 L-methionyl-tRNA(met)[c] + 9 L-phenylalanyl-tRNA(phe)[c] + 3 L-prolyl-tRNA(pro)[c] + 7 L-seryl-tRNA(ser)[c] + 4 L-threonyl-tRNA(thr)[c] + L-tryptophanyl-tRNA(trp)[c] + L-tyrosyl-tRNA(tyr)[c] + 11 L-valyl-tRNA(val)[c] => 315 ADP[c] + 315 Pi[c] + thioredoxin[c] + 8 tRNA(ala)[c] + 3 tRNA(asn)[c] + 7 tRNA(asp)[c] + 5 tRNA(cys)[c] + 5 tRNA(gln)[c] + 10 tRNA(glu)[c] + 5 tRNA(gly)[c] + tRNA(his)[c] + 4 tRNA(ile)[c] + 6 tRNA(leu)[c] + 12 tRNA(lys)[c] + 3 tRNA(met)[c] + 9 tRNA(phe)[c] + 3 tRNA(pro)[c] + 7 tRNA(ser)[c] + 4 tRNA(thr)[c] + tRNA(trp)[c] + tRNA(tyr)[c] + 11 tRNA(val)[c] + 415 H+[c]
HMR_5168	498 ATP[c] + 10 glycyl-tRNA(gly)[c] + 499 H2O[c] + 11 L-alanyl-tRNA(ala)[c] + 9 L-arginyl-tRNA(arg)[c] + 4 L-asparaginyl-tRNA(asn)[c] + 12 L-aspartyl-tRNA(asp)[c] + 3 L-cysteinyl-tRNA(cys)[c] + 10 L-glutaminyl-tRNA(gln)[c] + 6 L-glutamyl-tRNA(glu)[c] + 3 L-histidyl-tRNA(his)[c] + 9 L-isoleucyl-tRNA(ile)[c] + 15 L-leucyl-tRNA(leu)[c] + 11 L-lysyl-tRNA(lys)[c] + 4 L-methionyl-tRNA(met)[c] + 6 L-phenylalanyl-tRNA(phe)[c] + 12 L-prolyl-tRNA(pro)[c] + 8 L-seryl-tRNA(ser)[c] + 12 L-threonyl-tRNA(thr)[c] + 2 L-tryptophanyl-tRNA(trp)[c] + 2 L-tyrosyl-tRNA(tyr)[c] + 17 L-valyl-tRNA(val)[c] => 498 ADP[c] + mitothioredoxin[c] + 498 Pi[c] + 11 tRNA(ala)[c] + 9 tRNA(arg)[c] + 4 tRNA(asn)[c] + 12 tRNA(asp)[c] + 3 tRNA(cys)[c] + 10 tRNA(gln)[c] + 6 tRNA(glu)[c] + 10 tRNA(gly)[c] + 3 tRNA(his)[c] + 9 tRNA(ile)[c] + 15 tRNA(leu)[c] + 11 tRNA(lys)[c] + 4 tRNA(met)[c] + 6 tRNA(phe)[c] + 12 tRNA(pro)[c] + 8 tRNA(ser)[c] + 12 tRNA(thr)[c] + 2 tRNA(trp)[c] + 2 tRNA(tyr)[c] + 17 tRNA(val)[c] + 666 H+[c]
HMR_9817	104 ATP[c] + 208 H2O[c] + thioredoxin[c] => 104 ADP[c] + 8 alanine[c] + 3 asparagine[c] + 7 aspartate[c] + 5 cysteine[c] + 10 glutamate[c] + 5 glutamine[c] + 5 glycine[c] + histidine[c] + 4 isoleucine[c] + 6 leucine[c] + 12 lysine[c] + 3 methionine[c] + 9 phenylalanine[c] + 104 Pi[c] + 3 proline[c] + 7 serine[c] + 4 threonine[c] + tryptophan[c] + tyrosine[c] + 11 valine[c] + 109 H+[c]
HMR_9818	165 ATP[c] + 330 H2O[c] + mitothioredoxin[c] => 165 ADP[c] + 11 alanine[c] + 9 arginine[c] + 4 asparagine[c] + 12 aspartate[c] + 3 cysteine[c] + 6 glutamate[c] + 10 glutamine[c] + 10 glycine[c] + 3 histidine[c] + 9 isoleucine[c] + 15 leucine[c] + 11 lysine[c] + 4 methionine[c] + 6 phenylalanine[c] + 165 Pi[c] + 12 proline[c] + 8 serine[c] + 12 threonine[c] + 2 tryptophan[c] + 2 tyrosine[c] + 17 valine[c] + 163 H+[c]
r1431	dADP[m] + H2O[m] + oxidized thioredoxin[m] => ADP[m] + thioredoxin[m]
r1432	dGDP[m] + H2O[m] + oxidized thioredoxin[m] => GDP[m] + thioredoxin[m]
r1433	NADP+[m] + thioredoxin[m] => H+[m] + oxidized thioredoxin[m] + NADPH[m]
RE0456M	thioredoxin[m] + UTP[m] <=> dUTP[m] + H2O[m] + oxidized thioredoxin[m]
HMR_5395	glycogenin[c] + 8 UDP-glucose[c] => glycogenin G8[c] + 8 UDP[c] + 8 H+[c]
HMR_5396	glycogenin G8[c] + 3 UDP-glucose[c] => glycogenin G11[c] + 3 UDP[c] + 3 H+[c]
HMR_5151	1827 ATP[c] + 13 glycyl-tRNA(gly)[c] + 1828 H2O[c] + 63 L-alanyl-tRNA(ala)[c] + 27 L-arginyl-tRNA(arg)[c] + 17 L-asparaginyl-tRNA(asn)[c] + 36 L-aspartyl-tRNA(asp)[c] + 35 L-cysteinyl-tRNA(cys)[c] + 20 L-glutaminyl-tRNA(gln)[c] + 62 L-glutamyl-tRNA(glu)[c] + 16 L-histidyl-tRNA(his)[c] + 9 L-isoleucyl-tRNA(ile)[c] + 64 L-leucyl-tRNA(leu)[c] + 60 L-lysyl-tRNA(lys)[c] + 7 L-methionyl-tRNA(met)[c] + 35 L-phenylalanyl-tRNA(phe)[c] + 24 L-prolyl-tRNA(pro)[c] + 28 L-seryl-tRNA(ser)[c] + 29 L-threonyl-tRNA(thr)[c] + 2 L-tryptophanyl-tRNA(trp)[c] + 19 L-tyrosyl-tRNA(tyr)[c] + 43 L-valyl-tRNA(val)[c] => 1827 ADP[c] + albumin[c] + 1827 Pi[c] + 63 tRNA(ala)[c] + 27 tRNA(arg)[c] + 17 tRNA(asn)[c] + 36 tRNA(asp)[c] + 35 tRNA(cys)[c] + 20 tRNA(gln)[c] + 62 tRNA(glu)[c] + 13 tRNA(gly)[c] + 16 tRNA(his)[c] + 9 tRNA(ile)[c] + 64 tRNA(leu)[c] + 60 tRNA(lys)[c] + 7 tRNA(met)[c] + 35 tRNA(phe)[c] + 24 tRNA(pro)[c] + 28 tRNA(ser)[c] + 29 tRNA(thr)[c] + 2 tRNA(trp)[c] + 19 tRNA(tyr)[c] + 43 tRNA(val)[c] + 2425 H+[c]
HMR_5152	1269 ATP[c] + 16 glycyl-tRNA(gly)[c] + 1270 H2O[c] + 34 L-alanyl-tRNA(ala)[c] + 16 L-arginyl-tRNA(arg)[c] + 19 L-asparaginyl-tRNA(asn)[c] + 25 L-aspartyl-tRNA(asp)[c] + 3 L-cysteinyl-tRNA(cys)[c] + 17 L-glutaminyl-tRNA(gln)[c] + 29 L-glutamyl-tRNA(glu)[c] + 9 L-histidyl-tRNA(his)[c] + 20 L-isoleucyl-tRNA(ile)[c] + 59 L-leucyl-tRNA(leu)[c] + 26 L-lysyl-tRNA(lys)[c] + 14 L-methionyl-tRNA(met)[c] + 25 L-phenylalanyl-tRNA(phe)[c] + 16 L-prolyl-tRNA(pro)[c] + 30 L-seryl-tRNA(ser)[c] + 29 L-threonyl-tRNA(thr)[c] + 3 L-tryptophanyl-tRNA(trp)[c] + 9 L-tyrosyl-tRNA(tyr)[c] + 24 L-valyl-tRNA(val)[c] => 1269 ADP[c] + antichymotrypsin[c] + 1269 Pi[c] + 34 tRNA(ala)[c] + 16 tRNA(arg)[c] + 19 tRNA(asn)[c] + 25 tRNA(asp)[c] + 3 tRNA(cys)[c] + 17 tRNA(gln)[c] + 29 tRNA(glu)[c] + 16 tRNA(gly)[c] + 9 tRNA(his)[c] + 20 tRNA(ile)[c] + 59 tRNA(leu)[c] + 26 tRNA(lys)[c] + 14 tRNA(met)[c] + 25 tRNA(phe)[c] + 16 tRNA(pro)[c] + 30 tRNA(ser)[c] + 29 tRNA(thr)[c] + 3 tRNA(trp)[c] + 9 tRNA(tyr)[c] + 24 tRNA(val)[c] + 1680 H+[c]
HMR_5153	1254 ATP[c] + 24 glycyl-tRNA(gly)[c] + 1255 H2O[c] + 26 L-alanyl-tRNA(ala)[c] + 7 L-arginyl-tRNA(arg)[c] + 19 L-asparaginyl-tRNA(asn)[c] + 24 L-aspartyl-tRNA(asp)[c] + 3 L-cysteinyl-tRNA(cys)[c] + 18 L-glutaminyl-tRNA(gln)[c] + 32 L-glutamyl-tRNA(glu)[c] + 13 L-histidyl-tRNA(his)[c] + 20 L-isoleucyl-tRNA(ile)[c] + 51 L-leucyl-tRNA(leu)[c] + 34 L-lysyl-tRNA(lys)[c] + 10 L-methionyl-tRNA(met)[c] + 27 L-phenylalanyl-tRNA(phe)[c] + 19 L-prolyl-tRNA(pro)[c] + 25 L-seryl-tRNA(ser)[c] + 30 L-threonyl-tRNA(thr)[c] + 3 L-tryptophanyl-tRNA(trp)[c] + 6 L-tyrosyl-tRNA(tyr)[c] + 27 L-valyl-tRNA(val)[c] => 1254 ADP[c] + antitrypsin[c] + 1254 Pi[c] + 26 tRNA(ala)[c] + 7 tRNA(arg)[c] + 19 tRNA(asn)[c] + 24 tRNA(asp)[c] + 3 tRNA(cys)[c] + 18 tRNA(gln)[c] + 32 tRNA(glu)[c] + 24 tRNA(gly)[c] + 13 tRNA(his)[c] + 20 tRNA(ile)[c] + 51 tRNA(leu)[c] + 34 tRNA(lys)[c] + 10 tRNA(met)[c] + 27 tRNA(phe)[c] + 19 tRNA(pro)[c] + 25 tRNA(ser)[c] + 30 tRNA(thr)[c] + 3 tRNA(trp)[c] + 6 tRNA(tyr)[c] + 27 tRNA(val)[c] + 1657 H+[c]
HMR_5154	13683 ATP[c] + 207 glycyl-tRNA(gly)[c] + 13684 H2O[c] + 275 L-alanyl-tRNA(ala)[c] + 150 L-arginyl-tRNA(arg)[c] + 247 L-asparaginyl-tRNA(asn)[c] + 233 L-aspartyl-tRNA(asp)[c] + 25 L-cysteinyl-tRNA(cys)[c] + 230 L-glutaminyl-tRNA(gln)[c] + 298 L-glutamyl-tRNA(glu)[c] + 115 L-histidyl-tRNA(his)[c] + 285 L-isoleucyl-tRNA(ile)[c] + 533 L-leucyl-tRNA(leu)[c] + 357 L-lysyl-tRNA(lys)[c] + 79 L-methionyl-tRNA(met)[c] + 224 L-phenylalanyl-tRNA(phe)[c] + 171 L-prolyl-tRNA(pro)[c] + 392 L-seryl-tRNA(ser)[c] + 300 L-threonyl-tRNA(thr)[c] + 37 L-tryptophanyl-tRNA(trp)[c] + 151 L-tyrosyl-tRNA(tyr)[c] + 252 L-valyl-tRNA(val)[c] => 13683 ADP[c] + apoB100[c] + 13683 Pi[c] + 275 tRNA(ala)[c] + 150 tRNA(arg)[c] + 247 tRNA(asn)[c] + 233 tRNA(asp)[c] + 25 tRNA(cys)[c] + 230 tRNA(gln)[c] + 298 tRNA(glu)[c] + 207 tRNA(gly)[c] + 115 tRNA(his)[c] + 285 tRNA(ile)[c] + 533 tRNA(leu)[c] + 357 tRNA(lys)[c] + 79 tRNA(met)[c] + 224 tRNA(phe)[c] + 171 tRNA(pro)[c] + 392 tRNA(ser)[c] + 300 tRNA(thr)[c] + 37 tRNA(trp)[c] + 151 tRNA(tyr)[c] + 252 tRNA(val)[c] + 18220 H+[c]
HMR_5155	372 ATP[c] + 6 glycyl-tRNA(gly)[c] + 373 H2O[c] + 11 L-alanyl-tRNA(ala)[c] + 9 L-arginyl-tRNA(arg)[c] + L-asparaginyl-tRNA(asn)[c] + 8 L-aspartyl-tRNA(asp)[c] + 2 L-cysteinyl-tRNA(cys)[c] + 7 L-glutaminyl-tRNA(gln)[c] + 5 L-glutamyl-tRNA(glu)[c] + L-histidyl-tRNA(his)[c] + 4 L-isoleucyl-tRNA(ile)[c] + 20 L-leucyl-tRNA(leu)[c] + 4 L-lysyl-tRNA(lys)[c] + 5 L-methionyl-tRNA(met)[c] + 3 L-phenylalanyl-tRNA(phe)[c] + 9 L-prolyl-tRNA(pro)[c] + 8 L-seryl-tRNA(ser)[c] + 6 L-threonyl-tRNA(thr)[c] + 4 L-tyrosyl-tRNA(tyr)[c] + 11 L-valyl-tRNA(val)[c] => 372 ADP[c] + apo-[ACP][c] + 372 Pi[c] + 11 tRNA(ala)[c] + 9 tRNA(arg)[c] + tRNA(asn)[c] + 8 tRNA(asp)[c] + 2 tRNA(cys)[c] + 7 tRNA(gln)[c] + 5 tRNA(glu)[c] + 6 tRNA(gly)[c] + tRNA(his)[c] + 4 tRNA(ile)[c] + 20 tRNA(leu)[c] + 4 tRNA(lys)[c] + 5 tRNA(met)[c] + 3 tRNA(phe)[c] + 9 tRNA(pro)[c] + 8 tRNA(ser)[c] + 6 tRNA(thr)[c] + 4 tRNA(tyr)[c] + 11 tRNA(val)[c] + 496 H+[c]
HMR_5156	261 ATP[c] + 3 glycyl-tRNA(gly)[c] + 262 H2O[c] + 3 L-alanyl-tRNA(ala)[c] + L-arginyl-tRNA(arg)[c] + L-asparaginyl-tRNA(asn)[c] + 13 L-aspartyl-tRNA(asp)[c] + L-cysteinyl-tRNA(cys)[c] + 3 L-glutaminyl-tRNA(gln)[c] + 9 L-glutamyl-tRNA(glu)[c] + L-histidyl-tRNA(his)[c] + 8 L-isoleucyl-tRNA(ile)[c] + 10 L-leucyl-tRNA(leu)[c] + 7 L-lysyl-tRNA(lys)[c] + 5 L-methionyl-tRNA(met)[c] + 3 L-phenylalanyl-tRNA(phe)[c] + 5 L-prolyl-tRNA(pro)[c] + 3 L-seryl-tRNA(ser)[c] + L-threonyl-tRNA(thr)[c] + 4 L-tyrosyl-tRNA(tyr)[c] + 6 L-valyl-tRNA(val)[c] => 261 ADP[c] + mitoApo-[ACP][c] + 261 Pi[c] + 3 tRNA(ala)[c] + tRNA(arg)[c] + tRNA(asn)[c] + 13 tRNA(asp)[c] + tRNA(cys)[c] + 3 tRNA(gln)[c] + 9 tRNA(glu)[c] + 3 tRNA(gly)[c] + tRNA(his)[c] + 8 tRNA(ile)[c] + 10 tRNA(leu)[c] + 7 tRNA(lys)[c] + 5 tRNA(met)[c] + 3 tRNA(phe)[c] + 5 tRNA(pro)[c] + 3 tRNA(ser)[c] + tRNA(thr)[c] + 4 tRNA(tyr)[c] + 6 tRNA(val)[c] + 334 H+[c]
HMR_5157	249 ATP[c] + 3 glycyl-tRNA(gly)[c] + 250 H2O[c] + 5 L-alanyl-tRNA(ala)[c] + 4 L-arginyl-tRNA(arg)[c] + L-asparaginyl-tRNA(asn)[c] + 4 L-aspartyl-tRNA(asp)[c] + 3 L-glutaminyl-tRNA(gln)[c] + 8 L-glutamyl-tRNA(glu)[c] + 4 L-isoleucyl-tRNA(ile)[c] + 12 L-leucyl-tRNA(leu)[c] + 9 L-lysyl-tRNA(lys)[c] + 2 L-methionyl-tRNA(met)[c] + 4 L-phenylalanyl-tRNA(phe)[c] + 4 L-prolyl-tRNA(pro)[c] + 9 L-seryl-tRNA(ser)[c] + 3 L-threonyl-tRNA(thr)[c] + L-tryptophanyl-tRNA(trp)[c] + 7 L-valyl-tRNA(val)[c] => 249 ADP[c] + apoC1[c] + 249 Pi[c] + 5 tRNA(ala)[c] + 4 tRNA(arg)[c] + tRNA(asn)[c] + 4 tRNA(asp)[c] + 3 tRNA(gln)[c] + 8 tRNA(glu)[c] + 3 tRNA(gly)[c] + 4 tRNA(ile)[c] + 12 tRNA(leu)[c] + 9 tRNA(lys)[c] + 2 tRNA(met)[c] + 4 tRNA(phe)[c] + 4 tRNA(pro)[c] + 9 tRNA(ser)[c] + 3 tRNA(thr)[c] + tRNA(trp)[c] + 7 tRNA(val)[c] + 333 H+[c]
HMR_5158	303 ATP[c] + 5 glycyl-tRNA(gly)[c] + 304 H2O[c] + 7 L-alanyl-tRNA(ala)[c] + 2 L-arginyl-tRNA(arg)[c] + L-asparaginyl-tRNA(asn)[c] + 4 L-aspartyl-tRNA(asp)[c] + 8 L-glutaminyl-tRNA(gln)[c] + 8 L-glutamyl-tRNA(glu)[c] + L-isoleucyl-tRNA(ile)[c] + 15 L-leucyl-tRNA(leu)[c] + 6 L-lysyl-tRNA(lys)[c] + 3 L-methionyl-tRNA(met)[c] + 4 L-phenylalanyl-tRNA(phe)[c] + 5 L-prolyl-tRNA(pro)[c] + 9 L-seryl-tRNA(ser)[c] + 10 L-threonyl-tRNA(thr)[c] + L-tryptophanyl-tRNA(trp)[c] + 5 L-tyrosyl-tRNA(tyr)[c] + 7 L-valyl-tRNA(val)[c] => 303 ADP[c] + apoC2[c] + 303 Pi[c] + 7 tRNA(ala)[c] + 2 tRNA(arg)[c] + tRNA(asn)[c] + 4 tRNA(asp)[c] + 8 tRNA(gln)[c] + 8 tRNA(glu)[c] + 5 tRNA(gly)[c] + tRNA(ile)[c] + 15 tRNA(leu)[c] + 6 tRNA(lys)[c] + 3 tRNA(met)[c] + 4 tRNA(phe)[c] + 5 tRNA(pro)[c] + 9 tRNA(ser)[c] + 10 tRNA(thr)[c] + tRNA(trp)[c] + 5 tRNA(tyr)[c] + 7 tRNA(val)[c] + 400 H+[c]
HMR_5159	297 ATP[c] + 3 glycyl-tRNA(gly)[c] + 298 H2O[c] + 15 L-alanyl-tRNA(ala)[c] + 4 L-arginyl-tRNA(arg)[c] + 7 L-aspartyl-tRNA(asp)[c] + 6 L-glutaminyl-tRNA(gln)[c] + 5 L-glutamyl-tRNA(glu)[c] + L-histidyl-tRNA(his)[c] + 11 L-leucyl-tRNA(leu)[c] + 6 L-lysyl-tRNA(lys)[c] + 3 L-methionyl-tRNA(met)[c] + 4 L-phenylalanyl-tRNA(phe)[c] + 3 L-prolyl-tRNA(pro)[c] + 12 L-seryl-tRNA(ser)[c] + 5 L-threonyl-tRNA(thr)[c] + 3 L-tryptophanyl-tRNA(trp)[c] + 2 L-tyrosyl-tRNA(tyr)[c] + 9 L-valyl-tRNA(val)[c] => 297 ADP[c] + apoC3[c] + 297 Pi[c] + 15 tRNA(ala)[c] + 4 tRNA(arg)[c] + 7 tRNA(asp)[c] + 6 tRNA(gln)[c] + 5 tRNA(glu)[c] + 3 tRNA(gly)[c] + tRNA(his)[c] + 11 tRNA(leu)[c] + 6 tRNA(lys)[c] + 3 tRNA(met)[c] + 4 tRNA(phe)[c] + 3 tRNA(pro)[c] + 12 tRNA(ser)[c] + 5 tRNA(thr)[c] + 3 tRNA(trp)[c] + 2 tRNA(tyr)[c] + 9 tRNA(val)[c] + 394 H+[c]
HMR_5160	8022 ATP[c] + 262 glycyl-tRNA(gly)[c] + 8023 H2O[c] + 134 L-alanyl-tRNA(ala)[c] + 134 L-arginyl-tRNA(arg)[c] + 138 L-asparaginyl-tRNA(asn)[c] + 176 L-aspartyl-tRNA(asp)[c] + 48 L-cysteinyl-tRNA(cys)[c] + 110 L-glutaminyl-tRNA(gln)[c] + 186 L-glutamyl-tRNA(glu)[c] + 62 L-histidyl-tRNA(his)[c] + 104 L-isoleucyl-tRNA(ile)[c] + 166 L-leucyl-tRNA(leu)[c] + 154 L-lysyl-tRNA(lys)[c] + 48 L-methionyl-tRNA(met)[c] + 98 L-phenylalanyl-tRNA(phe)[c] + 114 L-prolyl-tRNA(pro)[c] + 278 L-seryl-tRNA(ser)[c] + 182 L-threonyl-tRNA(thr)[c] + 60 L-tryptophanyl-tRNA(trp)[c] + 98 L-tyrosyl-tRNA(tyr)[c] + 122 L-valyl-tRNA(val)[c] => 8022 ADP[c] + fibrinogen[c] + 8022 Pi[c] + 134 tRNA(ala)[c] + 134 tRNA(arg)[c] + 138 tRNA(asn)[c] + 176 tRNA(asp)[c] + 48 tRNA(cys)[c] + 110 tRNA(gln)[c] + 186 tRNA(glu)[c] + 262 tRNA(gly)[c] + 62 tRNA(his)[c] + 104 tRNA(ile)[c] + 166 tRNA(leu)[c] + 154 tRNA(lys)[c] + 48 tRNA(met)[c] + 98 tRNA(phe)[c] + 114 tRNA(pro)[c] + 278 tRNA(ser)[c] + 182 tRNA(thr)[c] + 60 tRNA(trp)[c] + 98 tRNA(tyr)[c] + 122 tRNA(val)[c] + 10622 H+[c]
HMR_5161	1218 ATP[c] + 31 glycyl-tRNA(gly)[c] + 1219 H2O[c] + 30 L-alanyl-tRNA(ala)[c] + 9 L-arginyl-tRNA(arg)[c] + 21 L-asparaginyl-tRNA(asn)[c] + 25 L-aspartyl-tRNA(asp)[c] + 12 L-cysteinyl-tRNA(cys)[c] + 17 L-glutaminyl-tRNA(gln)[c] + 25 L-glutamyl-tRNA(glu)[c] + 13 L-histidyl-tRNA(his)[c] + 18 L-isoleucyl-tRNA(ile)[c] + 31 L-leucyl-tRNA(leu)[c] + 35 L-lysyl-tRNA(lys)[c] + 5 L-methionyl-tRNA(met)[c] + 8 L-phenylalanyl-tRNA(phe)[c] + 21 L-prolyl-tRNA(pro)[c] + 18 L-seryl-tRNA(ser)[c] + 22 L-threonyl-tRNA(thr)[c] + 8 L-tryptophanyl-tRNA(trp)[c] + 21 L-tyrosyl-tRNA(tyr)[c] + 36 L-valyl-tRNA(val)[c] => 1218 ADP[c] + haptoglobin[c] + 1218 Pi[c] + 30 tRNA(ala)[c] + 9 tRNA(arg)[c] + 21 tRNA(asn)[c] + 25 tRNA(asp)[c] + 12 tRNA(cys)[c] + 17 tRNA(gln)[c] + 25 tRNA(glu)[c] + 31 tRNA(gly)[c] + 13 tRNA(his)[c] + 18 tRNA(ile)[c] + 31 tRNA(leu)[c] + 35 tRNA(lys)[c] + 5 tRNA(met)[c] + 8 tRNA(phe)[c] + 21 tRNA(pro)[c] + 18 tRNA(ser)[c] + 22 tRNA(thr)[c] + 8 tRNA(trp)[c] + 21 tRNA(tyr)[c] + 36 tRNA(val)[c] + 1618 H+[c]
HMR_5162	2430 ATP[c] + 62 glycyl-tRNA(gly)[c] + 2431 H2O[c] + 37 L-alanyl-tRNA(ala)[c] + 42 L-arginyl-tRNA(arg)[c] + 40 L-asparaginyl-tRNA(asn)[c] + 36 L-aspartyl-tRNA(asp)[c] + 48 L-cysteinyl-tRNA(cys)[c] + 31 L-glutaminyl-tRNA(gln)[c] + 56 L-glutamyl-tRNA(glu)[c] + 24 L-histidyl-tRNA(his)[c] + 22 L-isoleucyl-tRNA(ile)[c] + 48 L-leucyl-tRNA(leu)[c] + 49 L-lysyl-tRNA(lys)[c] + 11 L-methionyl-tRNA(met)[c] + 21 L-phenylalanyl-tRNA(phe)[c] + 69 L-prolyl-tRNA(pro)[c] + 56 L-seryl-tRNA(ser)[c] + 61 L-threonyl-tRNA(thr)[c] + 19 L-tryptophanyl-tRNA(trp)[c] + 30 L-tyrosyl-tRNA(tyr)[c] + 48 L-valyl-tRNA(val)[c] => 2430 ADP[c] + 2430 Pi[c] + plasminogen[c] + 37 tRNA(ala)[c] + 42 tRNA(arg)[c] + 40 tRNA(asn)[c] + 36 tRNA(asp)[c] + 48 tRNA(cys)[c] + 31 tRNA(gln)[c] + 56 tRNA(glu)[c] + 62 tRNA(gly)[c] + 24 tRNA(his)[c] + 22 tRNA(ile)[c] + 48 tRNA(leu)[c] + 49 tRNA(lys)[c] + 11 tRNA(met)[c] + 21 tRNA(phe)[c] + 69 tRNA(pro)[c] + 56 tRNA(ser)[c] + 61 tRNA(thr)[c] + 19 tRNA(trp)[c] + 30 tRNA(tyr)[c] + 48 tRNA(val)[c] + 3239 H+[c]
HMR_5163	1866 ATP[c] + 49 glycyl-tRNA(gly)[c] + 1867 H2O[c] + 42 L-alanyl-tRNA(ala)[c] + 44 L-arginyl-tRNA(arg)[c] + 25 L-asparaginyl-tRNA(asn)[c] + 35 L-aspartyl-tRNA(asp)[c] + 26 L-cysteinyl-tRNA(cys)[c] + 26 L-glutaminyl-tRNA(gln)[c] + 51 L-glutamyl-tRNA(glu)[c] + 13 L-histidyl-tRNA(his)[c] + 22 L-isoleucyl-tRNA(ile)[c] + 51 L-leucyl-tRNA(leu)[c] + 29 L-lysyl-tRNA(lys)[c] + 9 L-methionyl-tRNA(met)[c] + 21 L-phenylalanyl-tRNA(phe)[c] + 33 L-prolyl-tRNA(pro)[c] + 38 L-seryl-tRNA(ser)[c] + 36 L-threonyl-tRNA(thr)[c] + 14 L-tryptophanyl-tRNA(trp)[c] + 21 L-tyrosyl-tRNA(tyr)[c] + 37 L-valyl-tRNA(val)[c] => 1866 ADP[c] + 1866 Pi[c] + prothrombin[c] + 42 tRNA(ala)[c] + 44 tRNA(arg)[c] + 25 tRNA(asn)[c] + 35 tRNA(asp)[c] + 26 tRNA(cys)[c] + 26 tRNA(gln)[c] + 51 tRNA(glu)[c] + 49 tRNA(gly)[c] + 13 tRNA(his)[c] + 22 tRNA(ile)[c] + 51 tRNA(leu)[c] + 29 tRNA(lys)[c] + 9 tRNA(met)[c] + 21 tRNA(phe)[c] + 33 tRNA(pro)[c] + 38 tRNA(ser)[c] + 36 tRNA(thr)[c] + 14 tRNA(trp)[c] + 21 tRNA(tyr)[c] + 37 tRNA(val)[c] + 2475 H+[c]
HMR_5164	2094 ATP[c] + 52 glycyl-tRNA(gly)[c] + 2095 H2O[c] + 61 L-alanyl-tRNA(ala)[c] + 27 L-arginyl-tRNA(arg)[c] + 34 L-asparaginyl-tRNA(asn)[c] + 45 L-aspartyl-tRNA(asp)[c] + 40 L-cysteinyl-tRNA(cys)[c] + 17 L-glutaminyl-tRNA(gln)[c] + 42 L-glutamyl-tRNA(glu)[c] + 19 L-histidyl-tRNA(his)[c] + 15 L-isoleucyl-tRNA(ile)[c] + 65 L-leucyl-tRNA(leu)[c] + 58 L-lysyl-tRNA(lys)[c] + 10 L-methionyl-tRNA(met)[c] + 28 L-phenylalanyl-tRNA(phe)[c] + 32 L-prolyl-tRNA(pro)[c] + 41 L-seryl-tRNA(ser)[c] + 30 L-threonyl-tRNA(thr)[c] + 8 L-tryptophanyl-tRNA(trp)[c] + 26 L-tyrosyl-tRNA(tyr)[c] + 48 L-valyl-tRNA(val)[c] => [apotransferin][c] + 2094 ADP[c] + 2094 Pi[c] + 61 tRNA(ala)[c] + 27 tRNA(arg)[c] + 34 tRNA(asn)[c] + 45 tRNA(asp)[c] + 40 tRNA(cys)[c] + 17 tRNA(gln)[c] + 42 tRNA(glu)[c] + 52 tRNA(gly)[c] + 19 tRNA(his)[c] + 15 tRNA(ile)[c] + 65 tRNA(leu)[c] + 58 tRNA(lys)[c] + 10 tRNA(met)[c] + 28 tRNA(phe)[c] + 32 tRNA(pro)[c] + 41 tRNA(ser)[c] + 30 tRNA(thr)[c] + 8 tRNA(trp)[c] + 26 tRNA(tyr)[c] + 48 tRNA(val)[c] + 2790 H+[c]
HMR_5165	951 ATP[c] + 18 glycyl-tRNA(gly)[c] + 952 H2O[c] + 39 L-alanyl-tRNA(ala)[c] + 34 L-arginyl-tRNA(arg)[c] + L-asparaginyl-tRNA(asn)[c] + 11 L-aspartyl-tRNA(asp)[c] + 2 L-cysteinyl-tRNA(cys)[c] + 32 L-glutaminyl-tRNA(gln)[c] + 40 L-glutamyl-tRNA(glu)[c] + 2 L-histidyl-tRNA(his)[c] + 2 L-isoleucyl-tRNA(ile)[c] + 41 L-leucyl-tRNA(leu)[c] + 13 L-lysyl-tRNA(lys)[c] + 8 L-methionyl-tRNA(met)[c] + 4 L-phenylalanyl-tRNA(phe)[c] + 8 L-prolyl-tRNA(pro)[c] + 14 L-seryl-tRNA(ser)[c] + 12 L-threonyl-tRNA(thr)[c] + 8 L-tryptophanyl-tRNA(trp)[c] + 4 L-tyrosyl-tRNA(tyr)[c] + 24 L-valyl-tRNA(val)[c] => 951 ADP[c] + apoE[c] + 951 Pi[c] + 39 tRNA(ala)[c] + 34 tRNA(arg)[c] + tRNA(asn)[c] + 11 tRNA(asp)[c] + 2 tRNA(cys)[c] + 32 tRNA(gln)[c] + 40 tRNA(glu)[c] + 18 tRNA(gly)[c] + 2 tRNA(his)[c] + 2 tRNA(ile)[c] + 41 tRNA(leu)[c] + 13 tRNA(lys)[c] + 8 tRNA(met)[c] + 4 tRNA(phe)[c] + 8 tRNA(pro)[c] + 14 tRNA(ser)[c] + 12 tRNA(thr)[c] + 8 tRNA(trp)[c] + 4 tRNA(tyr)[c] + 24 tRNA(val)[c] + 1264 H+[c]
HMR_5166	801 ATP[c] + 11 glycyl-tRNA(gly)[c] + 802 H2O[c] + 23 L-alanyl-tRNA(ala)[c] + 17 L-arginyl-tRNA(arg)[c] + 5 L-asparaginyl-tRNA(asn)[c] + 16 L-aspartyl-tRNA(asp)[c] + 19 L-glutaminyl-tRNA(gln)[c] + 30 L-glutamyl-tRNA(glu)[c] + 6 L-histidyl-tRNA(his)[c] + 41 L-leucyl-tRNA(leu)[c] + 22 L-lysyl-tRNA(lys)[c] + 4 L-methionyl-tRNA(met)[c] + 8 L-phenylalanyl-tRNA(phe)[c] + 10 L-prolyl-tRNA(pro)[c] + 16 L-seryl-tRNA(ser)[c] + 12 L-threonyl-tRNA(thr)[c] + 5 L-tryptophanyl-tRNA(trp)[c] + 7 L-tyrosyl-tRNA(tyr)[c] + 15 L-valyl-tRNA(val)[c] => 801 ADP[c] + apoA1[c] + 801 Pi[c] + 23 tRNA(ala)[c] + 17 tRNA(arg)[c] + 5 tRNA(asn)[c] + 16 tRNA(asp)[c] + 19 tRNA(gln)[c] + 30 tRNA(glu)[c] + 11 tRNA(gly)[c] + 6 tRNA(his)[c] + 41 tRNA(leu)[c] + 22 tRNA(lys)[c] + 4 tRNA(met)[c] + 8 tRNA(phe)[c] + 10 tRNA(pro)[c] + 16 tRNA(ser)[c] + 12 tRNA(thr)[c] + 5 tRNA(trp)[c] + 7 tRNA(tyr)[c] + 15 tRNA(val)[c] + 1061 H+[c]
HMR_5169	855 ATP[c] + 21 glycyl-tRNA(gly)[c] + 856 H2O[c] + 21 L-alanyl-tRNA(ala)[c] + 20 L-arginyl-tRNA(arg)[c] + 11 L-asparaginyl-tRNA(asn)[c] + 10 L-aspartyl-tRNA(asp)[c] + 5 L-cysteinyl-tRNA(cys)[c] + 17 L-glutaminyl-tRNA(gln)[c] + 22 L-glutamyl-tRNA(glu)[c] + 6 L-histidyl-tRNA(his)[c] + 10 L-isoleucyl-tRNA(ile)[c] + 31 L-leucyl-tRNA(leu)[c] + 19 L-lysyl-tRNA(lys)[c] + 12 L-methionyl-tRNA(met)[c] + 6 L-phenylalanyl-tRNA(phe)[c] + 12 L-prolyl-tRNA(pro)[c] + 20 L-seryl-tRNA(ser)[c] + 12 L-threonyl-tRNA(thr)[c] + 5 L-tryptophanyl-tRNA(trp)[c] + 4 L-tyrosyl-tRNA(tyr)[c] + 21 L-valyl-tRNA(val)[c] => 855 ADP[c] + 855 Pi[c] + STAR[c] + 21 tRNA(ala)[c] + 20 tRNA(arg)[c] + 11 tRNA(asn)[c] + 10 tRNA(asp)[c] + 5 tRNA(cys)[c] + 17 tRNA(gln)[c] + 22 tRNA(glu)[c] + 21 tRNA(gly)[c] + 6 tRNA(his)[c] + 10 tRNA(ile)[c] + 31 tRNA(leu)[c] + 19 tRNA(lys)[c] + 12 tRNA(met)[c] + 6 tRNA(phe)[c] + 12 tRNA(pro)[c] + 20 tRNA(ser)[c] + 12 tRNA(thr)[c] + 5 tRNA(trp)[c] + 4 tRNA(tyr)[c] + 21 tRNA(val)[c] + 1147 H+[c]
HMR_5170	579 ATP[c] + 13 glycyl-tRNA(gly)[c] + 580 H2O[c] + 10 L-alanyl-tRNA(ala)[c] + 4 L-arginyl-tRNA(arg)[c] + 3 L-asparaginyl-tRNA(asn)[c] + 9 L-aspartyl-tRNA(asp)[c] + 8 L-cysteinyl-tRNA(cys)[c] + 4 L-glutaminyl-tRNA(gln)[c] + 11 L-glutamyl-tRNA(glu)[c] + 3 L-histidyl-tRNA(his)[c] + 12 L-isoleucyl-tRNA(ile)[c] + 28 L-leucyl-tRNA(leu)[c] + 11 L-lysyl-tRNA(lys)[c] + 4 L-methionyl-tRNA(met)[c] + 5 L-phenylalanyl-tRNA(phe)[c] + 19 L-prolyl-tRNA(pro)[c] + 20 L-seryl-tRNA(ser)[c] + 10 L-threonyl-tRNA(thr)[c] + 3 L-tryptophanyl-tRNA(trp)[c] + 4 L-tyrosyl-tRNA(tyr)[c] + 12 L-valyl-tRNA(val)[c] => 579 ADP[c] + GM2A[c] + 579 Pi[c] + 10 tRNA(ala)[c] + 4 tRNA(arg)[c] + 3 tRNA(asn)[c] + 9 tRNA(asp)[c] + 8 tRNA(cys)[c] + 4 tRNA(gln)[c] + 11 tRNA(glu)[c] + 13 tRNA(gly)[c] + 3 tRNA(his)[c] + 12 tRNA(ile)[c] + 28 tRNA(leu)[c] + 11 tRNA(lys)[c] + 4 tRNA(met)[c] + 5 tRNA(phe)[c] + 19 tRNA(pro)[c] + 20 tRNA(ser)[c] + 10 tRNA(thr)[c] + 3 tRNA(trp)[c] + 4 tRNA(tyr)[c] + 12 tRNA(val)[c] + 767 H+[c]
HMR_5171	975 ATP[c] + 28 glycyl-tRNA(gly)[c] + 976 H2O[c] + 38 L-alanyl-tRNA(ala)[c] + 23 L-arginyl-tRNA(arg)[c] + 5 L-asparaginyl-tRNA(asn)[c] + 14 L-aspartyl-tRNA(asp)[c] + 6 L-cysteinyl-tRNA(cys)[c] + 7 L-glutaminyl-tRNA(gln)[c] + 15 L-glutamyl-tRNA(glu)[c] + 10 L-histidyl-tRNA(his)[c] + 6 L-isoleucyl-tRNA(ile)[c] + 37 L-leucyl-tRNA(leu)[c] + 14 L-lysyl-tRNA(lys)[c] + 14 L-methionyl-tRNA(met)[c] + 10 L-phenylalanyl-tRNA(phe)[c] + 26 L-prolyl-tRNA(pro)[c] + 25 L-seryl-tRNA(ser)[c] + 10 L-threonyl-tRNA(thr)[c] + 3 L-tryptophanyl-tRNA(trp)[c] + 14 L-tyrosyl-tRNA(tyr)[c] + 20 L-valyl-tRNA(val)[c] => 975 ADP[c] + apocytochrome-C[c] + 975 Pi[c] + 38 tRNA(ala)[c] + 23 tRNA(arg)[c] + 5 tRNA(asn)[c] + 14 tRNA(asp)[c] + 6 tRNA(cys)[c] + 7 tRNA(gln)[c] + 15 tRNA(glu)[c] + 28 tRNA(gly)[c] + 10 tRNA(his)[c] + 6 tRNA(ile)[c] + 37 tRNA(leu)[c] + 14 tRNA(lys)[c] + 14 tRNA(met)[c] + 10 tRNA(phe)[c] + 26 tRNA(pro)[c] + 25 tRNA(ser)[c] + 10 tRNA(thr)[c] + 3 tRNA(trp)[c] + 14 tRNA(tyr)[c] + 20 tRNA(val)[c] + 1308 H+[c]
HMR_5172	1050 ATP[c] + 18 glycyl-tRNA(gly)[c] + 1051 H2O[c] + 22 L-alanyl-tRNA(ala)[c] + 12 L-arginyl-tRNA(arg)[c] + 12 L-asparaginyl-tRNA(asn)[c] + 26 L-aspartyl-tRNA(asp)[c] + 6 L-cysteinyl-tRNA(cys)[c] + 14 L-glutaminyl-tRNA(gln)[c] + 15 L-glutamyl-tRNA(glu)[c] + 9 L-histidyl-tRNA(his)[c] + 12 L-isoleucyl-tRNA(ile)[c] + 39 L-leucyl-tRNA(leu)[c] + 18 L-lysyl-tRNA(lys)[c] + 8 L-methionyl-tRNA(met)[c] + 20 L-phenylalanyl-tRNA(phe)[c] + 15 L-prolyl-tRNA(pro)[c] + 31 L-seryl-tRNA(ser)[c] + 25 L-threonyl-tRNA(thr)[c] + 7 L-tryptophanyl-tRNA(trp)[c] + 13 L-tyrosyl-tRNA(tyr)[c] + 28 L-valyl-tRNA(val)[c] => 1050 ADP[c] + glycogenin[c] + 1050 Pi[c] + 22 tRNA(ala)[c] + 12 tRNA(arg)[c] + 12 tRNA(asn)[c] + 26 tRNA(asp)[c] + 6 tRNA(cys)[c] + 14 tRNA(gln)[c] + 15 tRNA(glu)[c] + 18 tRNA(gly)[c] + 9 tRNA(his)[c] + 12 tRNA(ile)[c] + 39 tRNA(leu)[c] + 18 tRNA(lys)[c] + 8 tRNA(met)[c] + 20 tRNA(phe)[c] + 15 tRNA(pro)[c] + 31 tRNA(ser)[c] + 25 tRNA(thr)[c] + 7 tRNA(trp)[c] + 13 tRNA(tyr)[c] + 28 tRNA(val)[c] + 1389 H+[c]
HMR_5173	1404 ATP[c] + 28 glycyl-tRNA(gly)[c] + 1405 H2O[c] + 31 L-alanyl-tRNA(ala)[c] + 19 L-arginyl-tRNA(arg)[c] + 19 L-asparaginyl-tRNA(asn)[c] + 27 L-aspartyl-tRNA(asp)[c] + 19 L-cysteinyl-tRNA(cys)[c] + 16 L-glutaminyl-tRNA(gln)[c] + 34 L-glutamyl-tRNA(glu)[c] + 13 L-histidyl-tRNA(his)[c] + 29 L-isoleucyl-tRNA(ile)[c] + 47 L-leucyl-tRNA(leu)[c] + 33 L-lysyl-tRNA(lys)[c] + 15 L-methionyl-tRNA(met)[c] + 22 L-phenylalanyl-tRNA(phe)[c] + 20 L-prolyl-tRNA(pro)[c] + 37 L-seryl-tRNA(ser)[c] + 18 L-threonyl-tRNA(thr)[c] + 14 L-tyrosyl-tRNA(tyr)[c] + 27 L-valyl-tRNA(val)[c] => 1404 ADP[c] + 1404 Pi[c] + PPARA[c] + 31 tRNA(ala)[c] + 19 tRNA(arg)[c] + 19 tRNA(asn)[c] + 27 tRNA(asp)[c] + 19 tRNA(cys)[c] + 16 tRNA(gln)[c] + 34 tRNA(glu)[c] + 28 tRNA(gly)[c] + 13 tRNA(his)[c] + 29 tRNA(ile)[c] + 47 tRNA(leu)[c] + 33 tRNA(lys)[c] + 15 tRNA(met)[c] + 22 tRNA(phe)[c] + 20 tRNA(pro)[c] + 37 tRNA(ser)[c] + 18 tRNA(thr)[c] + 14 tRNA(tyr)[c] + 27 tRNA(val)[c] + 1863 H+[c]
HMR_5174	1425 ATP[c] + 32 glycyl-tRNA(gly)[c] + 1426 H2O[c] + 34 L-alanyl-tRNA(ala)[c] + 22 L-arginyl-tRNA(arg)[c] + 20 L-asparaginyl-tRNA(asn)[c] + 22 L-aspartyl-tRNA(asp)[c] + 10 L-cysteinyl-tRNA(cys)[c] + 13 L-glutaminyl-tRNA(gln)[c] + 31 L-glutamyl-tRNA(glu)[c] + 16 L-histidyl-tRNA(his)[c] + 25 L-isoleucyl-tRNA(ile)[c] + 38 L-leucyl-tRNA(leu)[c] + 35 L-lysyl-tRNA(lys)[c] + 7 L-methionyl-tRNA(met)[c] + 21 L-phenylalanyl-tRNA(phe)[c] + 20 L-prolyl-tRNA(pro)[c] + 43 L-seryl-tRNA(ser)[c] + 25 L-threonyl-tRNA(thr)[c] + 9 L-tryptophanyl-tRNA(trp)[c] + 17 L-tyrosyl-tRNA(tyr)[c] + 35 L-valyl-tRNA(val)[c] => 1425 ADP[c] + LPL[c] + 1425 Pi[c] + 34 tRNA(ala)[c] + 22 tRNA(arg)[c] + 20 tRNA(asn)[c] + 22 tRNA(asp)[c] + 10 tRNA(cys)[c] + 13 tRNA(gln)[c] + 31 tRNA(glu)[c] + 32 tRNA(gly)[c] + 16 tRNA(his)[c] + 25 tRNA(ile)[c] + 38 tRNA(leu)[c] + 35 tRNA(lys)[c] + 7 tRNA(met)[c] + 21 tRNA(phe)[c] + 20 tRNA(pro)[c] + 43 tRNA(ser)[c] + 25 tRNA(thr)[c] + 17 tRNA(tyr)[c] + 35 tRNA(val)[c] + 9 tRNA(trp)[c] + 1904 H+[c]
HMR_5258	albumin[c] + 608 ATP[c] + 1216 H2O[c] => 608 ADP[c] + 63 alanine[c] + 27 arginine[c] + 17 asparagine[c] + 36 aspartate[c] + 35 cysteine[c] + 62 glutamate[c] + 20 glutamine[c] + 13 glycine[c] + 16 histidine[c] + 9 isoleucine[c] + 64 leucine[c] + 60 lysine[c] + 7 methionine[c] + 35 phenylalanine[c] + 608 Pi[c] + 24 proline[c] + 28 serine[c] + 29 threonine[c] + 2 tryptophan[c] + 19 tyrosine[c] + 43 valine[c] + 619 H+[c]
HMR_5259	albumin[l] + 608 ATP[l] + 1216 H2O[l] => 608 ADP[l] + 63 alanine[l] + 27 arginine[l] + 17 asparagine[l] + 36 aspartate[l] + 35 cysteine[l] + 62 glutamate[l] + 20 glutamine[l] + 13 glycine[l] + 16 histidine[l] + 9 isoleucine[l] + 64 leucine[l] + 60 lysine[l] + 7 methionine[l] + 35 phenylalanine[l] + 608 Pi[l] + 24 proline[l] + 28 serine[l] + 29 threonine[l] + 2 tryptophan[l] + 19 tyrosine[l] + 43 valine[l] + 619 H+[c]
HMR_5260	antichymotrypsin[c] + 422 ATP[c] + 844 H2O[c] => 422 ADP[c] + 34 alanine[c] + 16 arginine[c] + 19 asparagine[c] + 25 aspartate[c] + 3 cysteine[c] + 29 glutamate[c] + 17 glutamine[c] + 16 glycine[c] + 9 histidine[c] + 20 isoleucine[c] + 59 leucine[c] + 26 lysine[c] + 14 methionine[c] + 25 phenylalanine[c] + 422 Pi[c] + 16 proline[c] + 30 serine[c] + 29 threonine[c] + 3 tryptophan[c] + 9 tyrosine[c] + 24 valine[c] + 434 H+[c]
HMR_5261	antichymotrypsin[l] + 422 ATP[l] + 844 H2O[l] => 422 ADP[l] + 34 alanine[l] + 16 arginine[l] + 19 asparagine[l] + 25 aspartate[l] + 3 cysteine[l] + 29 glutamate[l] + 17 glutamine[l] + 16 glycine[l] + 9 histidine[l] + 20 isoleucine[l] + 59 leucine[l] + 26 lysine[l] + 14 methionine[l] + 25 phenylalanine[l] + 422 Pi[l] + 16 proline[l] + 30 serine[l] + 29 threonine[l] + 3 tryptophan[l] + 9 tyrosine[l] + 24 valine[l] + 434 H+[l]
HMR_5262	antitrypsin[c] + 417 ATP[c] + 834 H2O[c] => 417 ADP[c] + 26 alanine[c] + 7 arginine[c] + 19 asparagine[c] + 24 aspartate[c] + 3 cysteine[c] + 32 glutamate[c] + 18 glutamine[c] + 24 glycine[c] + 13 histidine[c] + 20 isoleucine[c] + 51 leucine[c] + 34 lysine[c] + 10 methionine[c] + 27 phenylalanine[c] + 417 Pi[c] + 19 proline[c] + 25 serine[c] + 30 threonine[c] + 3 tryptophan[c] + 6 tyrosine[c] + 27 valine[c] + 432 H+[c]
HMR_5263	antitrypsin[l] + 417 ATP[l] + 834 H2O[l] => 417 ADP[l] + 26 alanine[l] + 7 arginine[l] + 19 asparagine[l] + 24 aspartate[l] + 3 cysteine[l] + 32 glutamate[l] + 18 glutamine[l] + 24 glycine[l] + 13 histidine[l] + 20 isoleucine[l] + 51 leucine[l] + 34 lysine[l] + 10 methionine[l] + 27 phenylalanine[l] + 417 Pi[l] + 19 proline[l] + 25 serine[l] + 30 threonine[l] + 3 tryptophan[l] + 6 tyrosine[l] + 27 valine[l] + 432 H+[l]
HMR_5264	apoB100[c] + 4560 ATP[c] + 9120 H2O[c] => 4560 ADP[c] + 275 alanine[c] + 150 arginine[c] + 247 asparagine[c] + 233 aspartate[c] + 25 cysteine[c] + 298 glutamate[c] + 230 glutamine[c] + 207 glycine[c] + 115 histidine[c] + 285 isoleucine[c] + 533 leucine[c] + 357 lysine[c] + 79 methionine[c] + 224 phenylalanine[c] + 4560 Pi[c] + 171 proline[c] + 392 serine[c] + 300 threonine[c] + 37 tryptophan[c] + 151 tyrosine[c] + 252 valine[c] + 4584 H+[c]
HMR_5265	apoB100[l] + 4560 ATP[l] + 9120 H2O[l] => 4560 ADP[l] + 275 alanine[l] + 150 arginine[l] + 247 asparagine[l] + 233 aspartate[l] + 25 cysteine[l] + 298 glutamate[l] + 230 glutamine[l] + 207 glycine[l] + 115 histidine[l] + 285 isoleucine[l] + 533 leucine[l] + 357 lysine[l] + 79 methionine[l] + 224 phenylalanine[l] + 4560 Pi[l] + 171 proline[l] + 392 serine[l] + 300 threonine[l] + 37 tryptophan[l] + 151 tyrosine[l] + 252 valine[l] + 4584 H+[l]
HMR_5266	apo-[ACP][c] + 123 ATP[c] + 246 H2O[c] => 123 ADP[c] + 11 alanine[c] + 9 arginine[c] + asparagine[c] + 8 aspartate[c] + 2 cysteine[c] + 5 glutamate[c] + 7 glutamine[c] + 6 glycine[c] + histidine[c] + 4 isoleucine[c] + 20 leucine[c] + 4 lysine[c] + 5 methionine[c] + 3 phenylalanine[c] + 123 Pi[c] + 9 proline[c] + 8 serine[c] + 6 threonine[c] + 4 tyrosine[c] + 11 valine[c] + 123 H+[c]
HMR_5267	86 ATP[m] + 172 H2O[m] + mitoApo-[ACP][m] => 86 ADP[m] + 3 alanine[m] + arginine[m] + asparagine[m] + 13 aspartate[m] + cysteine[m] + 9 glutamate[m] + 3 glutamine[m] + 3 glycine[m] + histidine[m] + 8 isoleucine[m] + 10 leucine[m] + 7 lysine[m] + 5 methionine[m] + 3 phenylalanine[m] + 86 Pi[m] + 5 proline[m] + 3 serine[m] + threonine[m] + 4 tyrosine[m] + 6 valine[m] + 100 H+[m]
HMR_5268	apoC1[c] + 82 ATP[c] + 164 H2O[c] => 82 ADP[c] + 5 alanine[c] + 4 arginine[c] + asparagine[c] + 4 aspartate[c] + 8 glutamate[c] + 3 glutamine[c] + 3 glycine[c] + 4 isoleucine[c] + 12 leucine[c] + 9 lysine[c] + 2 methionine[c] + 4 phenylalanine[c] + 82 Pi[c] + 4 proline[c] + 9 serine[c] + 3 threonine[c] + tryptophan[c] + 7 valine[c] + 81 H+[c]
HMR_5269	apoC2[c] + 100 ATP[c] + 200 H2O[c] => 100 ADP[c] + 7 alanine[c] + 2 arginine[c] + asparagine[c] + 4 aspartate[c] + 8 glutamate[c] + 8 glutamine[c] + 5 glycine[c] + isoleucine[c] + 15 leucine[c] + 6 lysine[c] + 3 methionine[c] + 4 phenylalanine[c] + 100 Pi[c] + 5 proline[c] + 9 serine[c] + 10 threonine[c] + tryptophan[c] + 5 tyrosine[c] + 7 valine[c] + 104 H+[c]
HMR_5270	apoC3[c] + 98 ATP[c] + 196 H2O[c] => 98 ADP[c] + 15 alanine[c] + 4 arginine[c] + 7 aspartate[c] + 5 glutamate[c] + 6 glutamine[c] + 3 glycine[c] + histidine[c] + 11 leucine[c] + 6 lysine[c] + 3 methionine[c] + 4 phenylalanine[c] + 98 Pi[c] + 3 proline[c] + 12 serine[c] + 5 threonine[c] + 3 tryptophan[c] + 2 tyrosine[c] + 9 valine[c] + 100 H+[c]
HMR_5271	2673 ATP[c] + fibrinogen[c] + 5346 H2O[c] => 2673 ADP[c] + 134 alanine[c] + 134 arginine[c] + 138 asparagine[c] + 176 aspartate[c] + 48 cysteine[c] + 186 glutamate[c] + 110 glutamine[c] + 262 glycine[c] + 62 histidine[c] + 104 isoleucine[c] + 166 leucine[c] + 154 lysine[c] + 48 methionine[c] + 98 phenylalanine[c] + 2673 Pi[c] + 114 proline[c] + 278 serine[c] + 182 threonine[c] + 60 tryptophan[c] + 98 tyrosine[c] + 122 valine[c] + 2747 H+[c]
HMR_5272	2673 ATP[l] + fibrinogen[l] + 5346 H2O[l] => 2673 ADP[l] + 134 alanine[l] + 134 arginine[l] + 138 asparagine[l] + 176 aspartate[l] + 48 cysteine[l] + 186 glutamate[l] + 110 glutamine[l] + 262 glycine[l] + 62 histidine[l] + 104 isoleucine[l] + 166 leucine[l] + 154 lysine[l] + 48 methionine[l] + 98 phenylalanine[l] + 2673 Pi[l] + 114 proline[l] + 278 serine[l] + 182 threonine[l] + 60 tryptophan[l] + 98 tyrosine[l] + 122 valine[l] + 2747 H+[l]
HMR_5273	405 ATP[c] + 810 H2O[c] + haptoglobin[c] => 405 ADP[c] + 30 alanine[c] + 9 arginine[c] + 21 asparagine[c] + 25 aspartate[c] + 12 cysteine[c] + 25 glutamate[c] + 17 glutamine[c] + 31 glycine[c] + 13 histidine[c] + 18 isoleucine[c] + 31 leucine[c] + 35 lysine[c] + 5 methionine[c] + 8 phenylalanine[c] + 405 Pi[c] + 21 proline[c] + 18 serine[c] + 22 threonine[c] + 8 tryptophan[c] + 21 tyrosine[c] + 36 valine[c] + 411 H+[c]
HMR_5274	405 ATP[l] + 810 H2O[l] + haptoglobin[l] => 405 ADP[l] + 30 alanine[l] + 9 arginine[l] + 21 asparagine[l] + 25 aspartate[l] + 12 cysteine[l] + 25 glutamate[l] + 17 glutamine[l] + 31 glycine[l] + 13 histidine[l] + 18 isoleucine[l] + 31 leucine[l] + 35 lysine[l] + 5 methionine[l] + 8 phenylalanine[l] + 405 Pi[l] + 21 proline[l] + 18 serine[l] + 22 threonine[l] + 8 tryptophan[l] + 21 tyrosine[l] + 36 valine[l] + 411 H+[l]
HMR_5275	809 ATP[c] + 1618 H2O[c] + plasminogen[c] => 809 ADP[c] + 37 alanine[c] + 42 arginine[c] + 40 asparagine[c] + 36 aspartate[c] + 48 cysteine[c] + 56 glutamate[c] + 31 glutamine[c] + 62 glycine[c] + 24 histidine[c] + 22 isoleucine[c] + 48 leucine[c] + 49 lysine[c] + 11 methionine[c] + 21 phenylalanine[c] + 809 Pi[c] + 69 proline[c] + 56 serine[c] + 61 threonine[c] + 19 tryptophan[c] + 30 tyrosine[c] + 48 valine[c] + 810 H+[c]
HMR_5276	809 ATP[l] + 1618 H2O[l] + plasminogen[l] => 809 ADP[l] + 37 alanine[l] + 42 arginine[l] + 40 asparagine[l] + 36 aspartate[l] + 48 cysteine[l] + 56 glutamate[l] + 31 glutamine[l] + 62 glycine[l] + 24 histidine[l] + 22 isoleucine[l] + 48 leucine[l] + 49 lysine[l] + 11 methionine[l] + 21 phenylalanine[l] + 809 Pi[l] + 69 proline[l] + 56 serine[l] + 61 threonine[l] + 19 tryptophan[l] + 30 tyrosine[l] + 48 valine[l] + 810 H+[l]
HMR_5277	621 ATP[c] + 1242 H2O[c] + prothrombin[c] => 621 ADP[c] + 42 alanine[c] + 44 arginine[c] + 25 asparagine[c] + 35 aspartate[c] + 26 cysteine[c] + 51 glutamate[c] + 26 glutamine[c] + 49 glycine[c] + 13 histidine[c] + 22 isoleucine[c] + 51 leucine[c] + 29 lysine[c] + 9 methionine[c] + 21 phenylalanine[c] + 621 Pi[c] + 33 proline[c] + 38 serine[c] + 36 threonine[c] + 14 tryptophan[c] + 21 tyrosine[c] + 37 valine[c] + 634 H+[c]
HMR_5278	621 ATP[l] + 1242 H2O[l] + prothrombin[l] => 621 ADP[l] + 42 alanine[l] + 44 arginine[l] + 25 asparagine[l] + 35 aspartate[l] + 26 cysteine[l] + 51 glutamate[l] + 26 glutamine[l] + 49 glycine[l] + 13 histidine[l] + 22 isoleucine[l] + 51 leucine[l] + 29 lysine[l] + 9 methionine[l] + 21 phenylalanine[l] + 621 Pi[l] + 33 proline[l] + 38 serine[l] + 36 threonine[l] + 14 tryptophan[l] + 21 tyrosine[l] + 37 valine[l] + 634 H+[l]
HMR_5279	[apotransferin][c] + 697 ATP[c] + 1394 H2O[c] => 697 ADP[c] + 61 alanine[c] + 27 arginine[c] + 34 asparagine[c] + 45 aspartate[c] + 40 cysteine[c] + 42 glutamate[c] + 17 glutamine[c] + 52 glycine[c] + 19 histidine[c] + 15 isoleucine[c] + 65 leucine[c] + 58 lysine[c] + 10 methionine[c] + 28 phenylalanine[c] + 697 Pi[c] + 32 proline[c] + 41 serine[c] + 30 threonine[c] + 8 tryptophan[c] + 26 tyrosine[c] + 48 valine[c] + 699 H+[c]
HMR_5280	[apotransferin][l] + 697 ATP[l] + 1394 H2O[l] => 697 ADP[l] + 61 alanine[l] + 27 arginine[l] + 34 asparagine[l] + 45 aspartate[l] + 40 cysteine[l] + 42 glutamate[l] + 17 glutamine[l] + 52 glycine[l] + 19 histidine[l] + 15 isoleucine[l] + 65 leucine[l] + 58 lysine[l] + 10 methionine[l] + 28 phenylalanine[l] + 697 Pi[l] + 32 proline[l] + 41 serine[l] + 30 threonine[l] + 8 tryptophan[l] + 26 tyrosine[l] + 48 valine[l] + 699 H+[l]
HMR_5281	apoE[c] + 316 ATP[c] + 632 H2O[c] => 316 ADP[c] + 39 alanine[c] + 34 arginine[c] + asparagine[c] + 11 aspartate[c] + 2 cysteine[c] + 40 glutamate[c] + 32 glutamine[c] + 18 glycine[c] + 2 histidine[c] + 2 isoleucine[c] + 41 leucine[c] + 13 lysine[c] + 8 methionine[c] + 4 phenylalanine[c] + 316 Pi[c] + 8 proline[c] + 14 serine[c] + 12 threonine[c] + 8 tryptophan[c] + 4 tyrosine[c] + 24 valine[c] + 320 H+[c]
HMR_5282	apoE[l] + 316 ATP[l] + 632 H2O[l] => 316 ADP[l] + 39 alanine[l] + 34 arginine[l] + asparagine[l] + 11 aspartate[l] + 2 cysteine[l] + 40 glutamate[l] + 32 glutamine[l] + 18 glycine[l] + 2 histidine[l] + 2 isoleucine[l] + 41 leucine[l] + 13 lysine[l] + 8 methionine[l] + 4 phenylalanine[l] + 316 Pi[l] + 8 proline[l] + 14 serine[l] + 12 threonine[l] + 8 tryptophan[l] + 4 tyrosine[l] + 24 valine[l] + 320 H+[l]
HMR_5283	apoA1[c] + 266 ATP[c] + 532 H2O[c] => 266 ADP[c] + 23 alanine[c] + 17 arginine[c] + 5 asparagine[c] + 16 aspartate[c] + 30 glutamate[c] + 19 glutamine[c] + 11 glycine[c] + 6 histidine[c] + 41 leucine[c] + 22 lysine[c] + 4 methionine[c] + 8 phenylalanine[c] + 266 Pi[c] + 10 proline[c] + 16 serine[c] + 12 threonine[c] + 5 tryptophan[c] + 7 tyrosine[c] + 15 valine[c] + 273 H+[c]
HMR_5284	apoA1[l] + 266 ATP[l] + 532 H2O[l] => 266 ADP[l] + 23 alanine[l] + 17 arginine[l] + 5 asparagine[l] + 16 aspartate[l] + 30 glutamate[l] + 19 glutamine[l] + 11 glycine[l] + 6 histidine[l] + 41 leucine[l] + 22 lysine[l] + 4 methionine[l] + 8 phenylalanine[l] + 266 Pi[l] + 10 proline[l] + 16 serine[l] + 12 threonine[l] + 5 tryptophan[l] + 7 tyrosine[l] + 15 valine[l] + 273 H+[l]
HMR_5285	284 ATP[l] + 568 H2O[l] + STAR[l] => 284 ADP[l] + 21 alanine[l] + 20 arginine[l] + 11 asparagine[l] + 10 aspartate[l] + 5 cysteine[l] + 22 glutamate[l] + 17 glutamine[l] + 21 glycine[l] + 6 histidine[l] + 10 isoleucine[l] + 31 leucine[l] + 19 lysine[l] + 12 methionine[l] + 6 phenylalanine[l] + 284 Pi[l] + 12 proline[l] + 20 serine[l] + 12 threonine[l] + 5 tryptophan[l] + 4 tyrosine[l] + 21 valine[l] + 277 H+[l]
HMR_5286	192 ATP[l] + GM2A[l] + 384 H2O[l] => 192 ADP[l] + 10 alanine[l] + 4 arginine[l] + 3 asparagine[l] + 9 aspartate[l] + 8 cysteine[l] + 11 glutamate[l] + 4 glutamine[l] + 13 glycine[l] + 3 histidine[l] + 12 isoleucine[l] + 28 leucine[l] + 11 lysine[l] + 4 methionine[l] + 5 phenylalanine[l] + 192 Pi[l] + 19 proline[l] + 20 serine[l] + 10 threonine[l] + 3 tryptophan[l] + 4 tyrosine[l] + 12 valine[l] + 197 H+[l]
HMR_5287	apocytochrome-C[l] + 324 ATP[l] + 648 H2O[l] => 324 ADP[l] + 38 alanine[l] + 23 arginine[l] + 5 asparagine[l] + 14 aspartate[l] + 6 cysteine[l] + 15 glutamate[l] + 7 glutamine[l] + 28 glycine[l] + 10 histidine[l] + 6 isoleucine[l] + 37 leucine[l] + 14 lysine[l] + 14 methionine[l] + 10 phenylalanine[l] + 324 Pi[l] + 26 proline[l] + 25 serine[l] + 10 threonine[l] + 3 tryptophan[l] + 14 tyrosine[l] + 20 valine[l] + 316 H+[l]
HMR_5288	349 ATP[c] + glycogenin[c] + 698 H2O[c] => 349 ADP[c] + 22 alanine[c] + 12 arginine[c] + 12 asparagine[c] + 26 aspartate[c] + 6 cysteine[c] + 15 glutamate[c] + 14 glutamine[c] + 18 glycine[c] + 9 histidine[c] + 12 isoleucine[c] + 39 leucine[c] + 18 lysine[c] + 8 methionine[c] + 20 phenylalanine[c] + 349 Pi[c] + 15 proline[c] + 31 serine[c] + 25 threonine[c] + 7 tryptophan[c] + 13 tyrosine[c] + 28 valine[c] + 360 H+[c]
HMR_5289	467 ATP[l] + 934 H2O[l] + PPARA[l] => 467 ADP[l] + 31 alanine[l] + 19 arginine[l] + 19 asparagine[l] + 27 aspartate[l] + 19 cysteine[l] + 34 glutamate[l] + 16 glutamine[l] + 28 glycine[l] + 13 histidine[l] + 29 isoleucine[l] + 47 leucine[l] + 33 lysine[l] + 15 methionine[l] + 22 phenylalanine[l] + 467 Pi[l] + 20 proline[l] + 37 serine[l] + 18 threonine[l] + 14 tyrosine[l] + 27 valine[l] + 476 H+[l]
HMR_5290	apoB48[l] + 4562 ATP[l] + 9124 H2O[l] => 4562 ADP[l] + 276 alanine[l] + 150 arginine[l] + 245 asparagine[l] + 234 aspartate[l] + 24 cysteine[l] + 297 glutamate[l] + 231 glutamine[l] + 207 glycine[l] + 114 histidine[l] + 287 isoleucine[l] + 536 leucine[l] + 356 lysine[l] + 79 methionine[l] + 224 phenylalanine[l] + 4562 Pi[l] + 171 proline[l] + 393 serine[l] + 299 threonine[l] + 37 tryptophan[l] + 153 tyrosine[l] + 250 valine[l] + 4587 H+[l]
HMR_5291	474 ATP[l] + 948 H2O[l] + LPL[l] => 474 ADP[l] + 34 alanine[l] + 22 arginine[l] + 20 asparagine[l] + 22 aspartate[l] + 10 cysteine[l] + 31 glutamate[l] + 13 glutamine[l] + 32 glycine[l] + 16 histidine[l] + 25 isoleucine[l] + 38 leucine[l] + 35 lysine[l] + 7 methionine[l] + 21 phenylalanine[l] + 474 Pi[l] + 20 proline[l] + 43 serine[l] + 25 threonine[l] + 9 tryptophan[l] + 17 tyrosine[l] + 35 valine[l] + 470 H+[l]
HMR_6399	apoA1[c] + lipoyl-AMP[c] => [protein]-N6-(lipoyl)lysine[c] + AMP[c] + H+[c]
HMR_4500	apo-[ACP][c] + CoA[c] => [ACP][c] + PAP[c] + H+[c]
HMR_9499	H2O[c] + S-palmitoylprotein[c] => [protein]-L-cysteine[c] + palmitate[c] + H+[c]
HMR_7167	H2O[c] + S-farnesyl-protein[c] => [protein C terminal]-S-farnesyl-L-cysteine[c] + protein N terminal[c]
HMR_7168	[protein C terminal]-S-farnesyl-L-cysteine[c] + SAM[c] => [protein C terminal]-S-farnesyl-L-cysteine-methyl ester[c] + SAH[c]
HMR_7169	[protein C terminal]-S-farnesyl-L-cysteine-methyl ester[c] + H2O[c] => S-[(2E,6E)-farnesyl]-L-cysteine methyl ester[c] + protein C terminal[c]
HMR_9545	H2O[c] + O2[c] + peptidyl-L-lysyl-peptide[c] => H2O2[c] + NH4+[c] + peptidyl-allysyl-peptide[c]
HMR_4702	homogentisate[c] + NADPH[c] + O2[c] => CO2[c] + gentisate aldehyde[c] + H2O[c] + NADP+[c]
HMR_6818	adrenaline[c] + O2[c] => adrenochrome[c] + 2 H2O[c] + H+[c]
HMR_6819	adrenochrome-O-semiquinone[c] + NADP+[c] + H+[c] <=> adrenochrome[c] + NADPH[c]
HMR_6822	noradrenaline[c] => 5 H+[c] + noradrenochrome[c]
HMR_6823	NADP+[c] + noradrenochrome-O-semiquinone[c] + H+[c] <=> NADPH[c] + noradrenochrome[c]
HMR_6885	L-dopachrome[c] + NADPH[c] <=> dopachrome-O-semiquinone[c] + NADP+[c] + H+[c]
HMR_8771	ATP[c] + GSH[c] + H2O[c] => ADP[c] + GSH[m] + Pi[c] + H+[c]
HMR_8691	dolichyl-diphosphate[r] + H2O[r] => dolichyl-phosphate[r] + Pi[r] + H+[r]
HMR_2152	acetyl-[ACP][c] + malonyl-[ACP][c] + H+[c] => [ACP][c] + acetoacetyl-[ACP][c] + CO2[c]
HMR_2156	butyryl-[ACP][c] + malonyl-[ACP][c] + H+[c] => [ACP][c] + 3-oxohexanoyl-[ACP][c] + CO2[c]
HMR_2160	hexanoyl-[ACP][c] + malonyl-[ACP][c] + H+[c] => [ACP][c] + 3-oxooctanoyl-[ACP][c] + CO2[c]
HMR_2164	malonyl-[ACP][c] + octanoyl-[ACP][c] + H+[c] => [ACP][c] + 3-oxodecanoyl-[ACP][c] + CO2[c]
HMR_2168	decanoyl-[ACP][c] + malonyl-[ACP][c] + H+[c] => [ACP][c] + 3-oxododecanoyl-[ACP][c] + CO2[c]
HMR_2173	dodecanoyl-[ACP][c] + malonyl-[ACP][c] + H+[c] => [ACP][c] + 3-oxotetradecanoyl-[ACP][c] + CO2[c]
HMR_2178	malonyl-[ACP][c] + tetradecanoyl-[ACP][c] + H+[c] => [ACP][c] + 3-oxohexadecanoyl-[ACP][c] + CO2[c]
HMR_2248	H2O[c] + tridecanoyl-[ACP][c] => [ACP][c] + tridecylic acid[c] + H+[c]
HMR_2253	H2O[c] + pentadecanoyl-[ACP][c] => [ACP][c] + pentadecylic acid[c] + H+[c]
HMR_2258	H2O[c] + heptadecanoyl-[ACP][c] => [ACP][c] + margaric acid[c] + H+[c]
HMR_2451	1-hydroperoxy-8-carboxyoctyl-3,4-epoxynon-(2E)-enyl-ether[c] <=> 4-oxo-2-nonenal[c] + azelaic acid[c] + 3 H+[c]
HMR_2452	1-hydroperoxy-8-carboxyoctyl-3,4-epoxynon-(2E)-enyl-ether[c] <=> 3,4-epoxynonanal[c] + azelaic acid[c] + H+[c]
HMR_1065	11,12-EET[c] + ATP[c] + CoA[c] + 2 H2O[c] + NAD+[c] + O2[c] => 9,10-epoxy-(6Z,12Z)-octadecadienoic acid[c] + acetyl-CoA[c] + AMP[c] + H2O2[c] + NADH[c] + PPi[c]
HMR_1066	9,10-epoxy-(6Z,12Z)-octadecadienoic acid[c] + ATP[c] + CoA[c] + 2 H2O[c] + NAD+[c] + O2[c] => 7,8-epoxy-(4Z,10Z)-hexadecadienoic acid[c] + acetyl-CoA[c] + AMP[c] + 2 H+[c] + H2O2[c] + NADH[c] + PPi[c]
HMR_1067	7,8-epoxy-(4Z,10Z)-hexadecadienoic acid[c] + ATP[c] + CoA[c] + 2 H2O[c] + NAD+[c] + O2[c] => 5,6-epoxy-(8Z)-tetradecenoic acid[c] + acetyl-CoA[c] + AMP[c] + H2O2[c] + NADH[c] + PPi[c]
HMR_1068	14,15-EET[c] + ATP[c] + CoA[c] + 2 H2O[c] + NAD+[c] + O2[c] => 12,13-epoxy-(6Z,9Z)-octadecadienoic acid[c] + acetyl-CoA[c] + AMP[c] + H2O2[c] + NADH[c] + PPi[c]
HMR_0294	(11Z)-eicosenoyl-CoA[c] + H2O[c] => cis-gondoic acid[c] + CoA[c] + H+[c]
HMR_3316	cis,cis-3,6-dodecadienoyl-CoA[p] => trans,cis-lauro-2,6-dienoyl-CoA[p]
HMR_3322	2-trans-4-cis-decadienoyl-CoA[p] + H+[p] + NADH[p] => NAD+[p] + trans-3-decenoyl-CoA[p]
HMR_3288	cis,cis-3,6-dodecadienoyl-CoA[m] => trans,cis-lauro-2,6-dienoyl-CoA[m]
HMR_3296	2-trans-4-cis-decadienoyl-CoA[m] + H+[m] + NADH[m] => NAD+[m] + trans-3-decenoyl-CoA[m]
HMR_6910	3-demethylubiquinol-10[m] + SAM[m] => H+[m] + SAH[m] + ubiquinol[m]
HMR_1932	cholesterol[c] + 2 H+[c] + O2[c] + 2 reduced adrenal ferredoxin[c] => 20-hydroxycholesterol[c] + H2O[c] + 2 oxidized adrenal ferredoxin[c]
HMR_1942	11-deoxycorticosterone[c] + O2[c] + 2 reduced ferredoxin[c] + 2 H+[c] => corticosterone[c] + H2O[c] + 2 oxidized ferredoxin[c]
HMR_1950	17alpha,21-dihydroxypregnenolone[c] + O2[c] + 2 reduced ferredoxin[c] + 2 H+[c] => 11beta,17alpha,21-trihydroxypregnenolone[c] + H2O[c] + 2 oxidized ferredoxin[c]
HMR_2031	19-oxo-testosterone[c] + NADPH[c] + O2[c] => estradiol-17beta[c] + formate[c] + H2O[c] + NADP+[c]
HMR_2034	19-oxoandrostenedione[c] + NADPH[c] + O2[c] => estrone[c] + formate[c] + H2O[c] + NADP+[c]
HMR_3547	cholesterol-ester-palmn[l] + H2O[l] => cholesterol[l] + palmitolate[l] + H+[l]
HMR_3693	cholesterol-ester-palmn[r] + H2O[r] => cholesterol[r] + palmitolate[r] + H+[r]
HMR_3561	cholesterol-ester-11-eico[l] + H2O[l] => cholesterol[l] + cis-gondoic acid[l] + H+[l]
HMR_3707	cholesterol-ester-11-eico[r] + H2O[r] => cholesterol[r] + cis-gondoic acid[r] + H+[r]
HMR_0879	paragloboside[c] + UDP-galactose[c] => nLc5Cer(G00051)[c] + UDP[c] + H+[c]
HMR_8383	dolichyl-phosphate-D-mannose[r] + glucosaminyl-acylphosphatidylinositol[r] => dolichyl-phosphate[r] + mgacpail heparan sulfate[r] + H+[r]
HMR_8384	dolichyl-phosphate-D-mannose[r] + mgacpail heparan sulfate[r] => dolichyl-phosphate[r] + m2gacpail heparan sulfate[r] + H+[r]
HMR_8385	dolichyl-phosphate-D-mannose[r] + m2gacpail heparan sulfate[r] => dolichyl-phosphate[r] + m3gacpail heparan sulfate[r] + H+[r]
HMR_8387	dolichyl-phosphate-D-mannose[r] + emgacpail heparan sulfate[r] => dolichyl-phosphate[r] + memgacpail heparan sulfate[r] + H+[r]
HMR_8388	dolichyl-phosphate-D-mannose[r] + memgacpail heparan sulfate[r] => dolichyl-phosphate[r] + m2emgacpail heparan sulfate[r] + H+[r]
HMR_8389	dolichyl-phosphate-D-mannose[r] + m2emgacpail heparan sulfate[r] => dolichyl-phosphate[r] + m3emgacpail heparan sulfate[r] + H+[r]
HMR_8390	dolichyl-phosphate-D-mannose[r] + em2emgacpail heparan sulfate[r] => dolichyl-phosphate[r] + mem2emgacpail heparan sulfate[r] + H+[r]
HMR_1339	12(S)-HHT[c] + malonic-dialdehyde[c] + H+[c] <=> prostaglandin H2[c]
HMR_1357	5,9-cyclo-6,8-cycloperoxy-12-hydroperoxy-(10E,14Z)-eicosadienoate[c] + 2 ascorbate[c] => 5,9-cyclo-6,8,12-trihydroxy-(10E,14Z)-eicosadienoic acid[c] + 2 dehydroascorbic acid[c] + H2O[c]
HMR_1360	9,11-cycloperoxy-5-hydroperoxy-(6E,14Z)-eicosadienoate[c] + 2 ascorbate[c] => 5,9,11-trihydroxyprosta-(6E,14Z)-dien-1-oate[c] + 2 dehydroascorbic acid[c] + H2O[c]
HMR_7228	acetyl-CoA[c] + heparan sulfate, degradation product 2[l] => CoA[c] + heparan sulfate, degradation product 3[l] + H+[l]
HMR_7233	acetyl-CoA[c] + heparan sulfate, degradation product 7[l] => CoA[c] + heparan sulfate, degradation product 8[l] + H+[l]
HMR_7239	acetyl-CoA[c] + heparan sulfate, degradation product 13[l] => CoA[c] + heparan sulfate, degradation product 14[l] + H+[l]
HMR_7245	acetyl-CoA[c] + heparan sulfate, degradation product 19[l] => CoA[c] + heparan sulfate, degradation product 20[l] + H+[l]
HMR_1592	7alpha,12alpha-dihydroxycholest-4-en-3-one[r] + ATP[r] + H2O[r] => 7alpha,12alpha-dihydroxycholest-4-en-3-one[c] + ADP[r] + Pi[r] + H+[r]
HMR_1622	3alpha,7alpha,12alpha-trihydroxy-5beta-cholestanate[c] + ATP[c] + H2O[c] => 3alpha,7alpha,12alpha-trihydroxy-5beta-cholestanate[p] + ADP[c] + Pi[c] + H+[c]
HMR_1659	ATP[c] + choloyl-CoA[c] + H2O[c] => ADP[c] + choloyl-CoA[p] + Pi[c] + H+[c]
HMR_1696	3alpha,7alpha-dihydroxy-5beta-cholestanate[c] + ATP[c] + H2O[c] => 3alpha,7alpha-dihydroxy-5beta-cholestanate[p] + ADP[c] + Pi[c] + H+[c]
HMR_1702	25(R)DHCA-CoA[r] + 2 ATP[r] + 2 H2O[r] => 25(R)DHCA-CoA[p] + 2 ADP[r] + 2 Pi[r] + 2 H+[r]
HMR_8658	ATP[c] + cholate[c] + H2O[c] => ADP[c] + cholate[s] + Pi[c] + H+[c]
HMR_1868	ATP[c] + glycocholate[c] + H2O[c] => ADP[c] + glycocholate[s] + Pi[c] + H+[c]
HMR_1853	ATP[c] + chenodiol[c] + H2O[c] => ADP[c] + chenodiol[s] + Pi[c] + H+[c]
HMR_1870	ATP[c] + H2O[c] + taurocholate[c] => ADP[c] + Pi[c] + taurocholate[s] + H+[c]
HMR_1857	2 ATP[p] + 2 H2O[p] + taurocholate[p] => 2 ADP[p] + 2 Pi[p] + taurocholate[s] + 2 H+[p]
HMR_1874	ATP[c] + glycochenodeoxycholate[c] + H2O[c] => ADP[c] + glycochenodeoxycholate[s] + Pi[c] + H+[c]
HMR_1872	ATP[c] + H2O[c] + taurochenodeoxycholate[c] => ADP[c] + Pi[c] + taurochenodeoxycholate[s] + H+[c]
HMR_1861	2 ATP[p] + 2 H2O[p] + taurochenodeoxycholate[p] => 2 ADP[p] + 2 Pi[p] + taurochenodeoxycholate[s] + 2 H+[p]
HMR_1895	ATP[r] + bilirubin-bisglucuronoside[r] + H2O[r] => ADP[r] + bilirubin-bisglucuronoside[s] + Pi[r] + H+[r]
HMR_1896	ATP[c] + bilirubin-bisglucuronoside[c] + H2O[c] => ADP[c] + bilirubin-bisglucuronoside[s] + Pi[c] + H+[c]
HMR_1897	ATP[r] + bilirubin-monoglucuronoside[r] + H2O[r] => ADP[r] + bilirubin-monoglucuronoside[s] + Pi[r] + H+[r]
HMR_8279	nLc5Cer[g] + UDP-galactose[g] => nLc6Cer[c] + UDP[g] + H+[g]
HMR_1800	cholest-5-ene-3beta,7alpha,27-triol[m] + 2 NADPH[m] + 2 O2[m] + H+[m] => 3beta,7alpha-dihydroxy-5-cholestenoate[m] + 3 H2O[m] + 2 NADP+[m]
HMR_3992	2 ferricytochrome B5[c] + NADH[c] <=> 2 ferrocytochrome B5[c] + NAD+[c] + H+[c]
HMR_4551	2 formyl-N-acetyl-5-methoxykynurenamine[c] + H2O2[c] => formate[c] + 2 N-acetyl-5-methoxykynuramine[c] + CO2[c] + H+[c]
HMR_8746	pyruvate[c] + thiamin-PP[c] + H+[c] => 2-(alpha-hydroxyethyl)thiamine-diphosphate[c] + CO2[c]
HMR_6428	13-hydroxy-alpha-tocotrienol[c] + 2 NADPH[c] + 2 O2[c] + H+[c] => 13-carboxy-alpha-tocotrienol[c] + 3 H2O[c] + 2 NADP+[c]
HMR_6429	13-hydroxy-alpha-tocotrienol[r] + 2 NADPH[r] + 2 O2[r] + H+[r] => 13-carboxy-alpha-tocotrienol[r] + 3 H2O[r] + 2 NADP+[r]
HMR_6443	13-hydroxy-gamma-tocotrienol[c] + 2 NADPH[c] + 2 O2[c] + H+[c] => 13-carboxy-gamma-tocotrienol[c] + 3 H2O[c] + 2 NADP+[c]
HMR_6444	13-hydroxy-gamma-tocotrienol[r] + 2 NADPH[r] + 2 O2[r] + H+[r] => 13-carboxy-gamma-tocotrienol[r] + 3 H2O[r] + 2 NADP+[r]
HMR_6466	13-hydroxy-gamma-tocopherol[c] + 2 NADPH[c] + 2 O2[c] + H+[c] => 13-carboxy-gamma-tocopherol[c] + 3 H2O[c] + 2 NADP+[c]
HMR_6467	13-hydroxy-gamma-tocopherol[r] + 2 NADPH[r] + 2 O2[r] + H+[r] => 13-carboxy-gamma-tocopherol[r] + 3 H2O[r] + 2 NADP+[r]
HMR_6478	13-hydroxy-alpha-tocopherol[c] + 2 NADPH[c] + 2 O2[c] + H+[c] => 13-carboxy-alpha-tocopherol[c] + 3 H2O[c] + 2 NADP+[c]
HMR_6479	13-hydroxy-alpha-tocopherol[r] + 2 NADPH[r] + 2 O2[r] + H+[r] => 13-carboxy-alpha-tocopherol[r] + 3 H2O[r] + 2 NADP+[r]
HMR_6459	5-nitro-gamma-tocopherol[c] <=> gamma-tocopheroxyl-radical[c] + nitrite[c]
HMR_7006	naphthalene-1,2-diol[c] => 1,2-naphthoquinone[c] + 2 H+[c]
HMR_7010	1,4-dihydroxynaphthalene[c] => 1,4-naphthoquinone[c] + 2 H+[c]
HMR_7026	1,2,3,4-tetrahydro-alpha,7-dihydroxy-beta-(hydroxymethyl)-9-methoxy-3,4-dioxocyclopenta[c][1]benzopyran-6-propanal[c] + 3 H+[c] => 6-[2,3-dihydroxy-1-(hydroxymethyl)propyl]-1,2-dihydro-7-hydroxy-9-methoxy-cyclopenta[c][1]benzopyran-3,4-dione[c]
HMR_7028	alpha-(1,2-dihydroxyethyl)-1,2,3,4-tetrahydro-7-hydroxy-9-methoxy-3,4-dioxocyclopenta[c][1]benzopyran-6-acetaldehyde[c] + 3 H+[c] => 6-[2,3-dihydroxy-1-(hydroxymethyl)propyl]-1,2-dihydro-7-hydroxy-9-methoxy-cyclopenta[c][1]benzopyran-3,4-dione[c]
HMR_7046	4-bromocatechol[c] => 4-bromo-3,5-cyclohexadiene-1,2-dione[c] + 2 H+[c]
HMR_7047	bromobenzene-3,4-dihydrodiol[c] => 4-bromocatechol[c] + 2 H+[c]
HMR_7086	1-nitrosonaphthalene[c] + 2 H+[c] => N-hydroxy-1-aminonaphthalene[c]
HMR_7103	1,2-dibromoethane[c] + GSH[c] => glutathione episulfonium ion[c] + 2 hydrobromic acid[c] + 2 H+[c]
HMR_7106	S-(formylmethyl)glutathione[c] + 3 H+[c] => S-(2-hydroxyethyl)glutathione[c]
HMR_9474	hippurate[c] + SAM[c] => O-methylhippurate[c] + SAH[c] + H+[c]
HMR_9509	G(5)pppR-RNA[c] + SAM[c] <=> m7G(5')pppR-RNA[c] + SAH[c]
HMR_9525	arsenite[c] + SAM[c] <=> methylarsonate[c] + SAH[c] + H+[c]
HMR_9541	L-arginyl-protein[c] + tRNA(arg)[c] + H+[c] <=> [protein][c] + L-arginyl-tRNA(arg)[c]
HMR_1185	4(R)-hydroxy-dodec-(6Z)-enoate[m] + CoA[m] => (2E)-dodecenoyl-CoA[m] + H+[m] + O2[m]
HMR_1227	4(S)-hydroxy-dodec-(6Z)-enoate[m] + CoA[m] => (2E)-dodecenoyl-CoA[m] + H+[m] + O2[m]
HMR_0190	ATP[c] + H2O[c] + lauric acid[c] => ADP[c] + lauric acid[s] + Pi[c] + H+[c]
HMR_0194	ATP[c] + H2O[c] + tridecylic acid[c] => ADP[c] + Pi[c] + tridecylic acid[s] + H+[c]
HMR_0198	ATP[c] + H2O[c] + myristic acid[c] => ADP[c] + myristic acid[s] + Pi[c] + H+[c]
HMR_0202	(9E)-tetradecenoic acid[c] + ATP[c] + H2O[c] => (9E)-tetradecenoic acid[s] + ADP[c] + Pi[c] + H+[c]
HMR_0207	(7Z)-tetradecenoic acid[c] + ATP[c] + H2O[c] => (7Z)-tetradecenoic acid[s] + ADP[c] + Pi[c] + H+[c]
HMR_0211	ATP[c] + H2O[c] + physeteric acid[c] => ADP[c] + physeteric acid[s] + Pi[c] + H+[c]
HMR_0215	ATP[c] + H2O[c] + pentadecylic acid[c] => ADP[c] + pentadecylic acid[s] + Pi[c] + H+[c]
HMR_0224	ATP[c] + H2O[c] + palmitate[c] => ADP[c] + palmitate[s] + Pi[c] + H+[c]
HMR_0231	ATP[c] + H2O[c] + palmitolate[c] => ADP[c] + palmitolate[s] + Pi[c] + H+[c]
HMR_0235	7-palmitoleic acid[c] + ATP[c] + H2O[c] => 7-palmitoleic acid[s] + ADP[c] + Pi[c] + H+[c]
HMR_0239	ATP[c] + H2O[c] + margaric acid[c] => ADP[c] + margaric acid[s] + Pi[c] + H+[c]
HMR_0243	(10Z)-heptadecenoic acid[c] + ATP[c] + H2O[c] => (10Z)-heptadecenoic acid[s] + ADP[c] + Pi[c] + H+[c]
HMR_0247	9-heptadecylenic acid[c] + ATP[c] + H2O[c] => 9-heptadecylenic acid[s] + ADP[c] + Pi[c] + H+[c]
HMR_0253	ATP[c] + H2O[c] + stearate[c] => ADP[c] + Pi[c] + stearate[s] + H+[c]
HMR_0257	(13Z)-octadecenoic acid[c] + ATP[c] + H2O[c] => (13Z)-octadecenoic acid[s] + ADP[c] + Pi[c] + H+[c]
HMR_0261	ATP[c] + cis-vaccenic acid[c] + H2O[c] => ADP[c] + cis-vaccenic acid[s] + Pi[c] + H+[c]
HMR_0265	ATP[c] + H2O[c] + oleate[c] => ADP[c] + oleate[s] + Pi[c] + H+[c]
HMR_0269	ATP[c] + elaidate[c] + H2O[c] => ADP[c] + elaidate[s] + Pi[c] + H+[c]
HMR_0273	(7Z)-octadecenoic acid[c] + ATP[c] + H2O[c] => (7Z)-octadecenoic acid[s] + ADP[c] + Pi[c] + H+[c]
HMR_0277	(6Z,9Z)-octadecadienoic acid[c] + ATP[c] + H2O[c] => (6Z,9Z)-octadecadienoic acid[s] + ADP[c] + Pi[c] + H+[c]
HMR_0281	ATP[c] + H2O[c] + nonadecylic acid[c] => ADP[c] + nonadecylic acid[s] + Pi[c] + H+[c]
HMR_0287	ATP[c] + eicosanoate[c] + H2O[c] => ADP[c] + eicosanoate[s] + Pi[c] + H+[c]
HMR_0291	(13Z)-eicosenoic acid[c] + ATP[c] + H2O[c] => (13Z)-eicosenoic acid[s] + ADP[c] + Pi[c] + H+[c]
HMR_0295	ATP[c] + cis-gondoic acid[c] + H2O[c] => ADP[c] + cis-gondoic acid[s] + Pi[c] + H+[c]
HMR_0299	9-eicosenoic acid[c] + ATP[c] + H2O[c] => 9-eicosenoic acid[s] + ADP[c] + Pi[c] + H+[c]
HMR_0303	8,11-eicosadienoic acid[c] + ATP[c] + H2O[c] => 8,11-eicosadienoic acid[s] + ADP[c] + Pi[c] + H+[c]
HMR_0307	ATP[c] + H2O[c] + mead acid[c] => ADP[c] + mead acid[s] + Pi[c] + H+[c]
HMR_0311	ATP[c] + H2O[c] + henicosanoic acid[c] => ADP[c] + henicosanoic acid[s] + Pi[c] + H+[c]
HMR_0317	ATP[c] + behenic acid[c] + H2O[c] => ADP[c] + behenic acid[s] + Pi[c] + H+[c]
HMR_0321	ATP[c] + cis-erucic acid[c] + H2O[c] => ADP[c] + cis-erucic acid[s] + Pi[c] + H+[c]
HMR_0325	ATP[c] + cis-cetoleic acid[c] + H2O[c] => ADP[c] + cis-cetoleic acid[s] + Pi[c] + H+[c]
HMR_0329	ATP[c] + H2O[c] + tricosanoic acid[c] => ADP[c] + Pi[c] + tricosanoic acid[s] + H+[c]
HMR_0335	ATP[c] + H2O[c] + lignocerate[c] => ADP[c] + lignocerate[s] + Pi[c] + H+[c]
HMR_0339	ATP[c] + H2O[c] + nervonic acid[c] => ADP[c] + nervonic acid[s] + Pi[c] + H+[c]
HMR_0343	ATP[c] + cerotic acid[c] + H2O[c] => ADP[c] + cerotic acid[s] + Pi[c] + H+[c]
HMR_0347	ATP[c] + H2O[c] + ximenic acid[c] => ADP[c] + Pi[c] + ximenic acid[s] + H+[c]
HMR_0351	ATP[c] + H2O[c] + linolenate[c] => ADP[c] + linolenate[s] + Pi[c] + H+[c]
HMR_0355	ATP[c] + H2O[c] + stearidonic acid[c] => ADP[c] + Pi[c] + stearidonic acid[s] + H+[c]
HMR_0359	ATP[c] + H2O[c] + omega-3-arachidonic acid[c] => ADP[c] + omega-3-arachidonic acid[s] + Pi[c] + H+[c]
HMR_0363	ATP[c] + EPA[c] + H2O[c] => ADP[c] + EPA[s] + Pi[c] + H+[c]
HMR_0367	ATP[c] + DPA[c] + H2O[c] => ADP[c] + DPA[s] + Pi[c] + H+[c]
HMR_0371	(9Z,12Z,15Z,18Z,21Z)-TPA[c] + ATP[c] + H2O[c] => (9Z,12Z,15Z,18Z,21Z)-TPA[s] + ADP[c] + Pi[c] + H+[c]
HMR_0375	(6Z,9Z,12Z,15Z,18Z,21Z)-THA[c] + ATP[c] + H2O[c] => (6Z,9Z,12Z,15Z,18Z,21Z)-THA[s] + ADP[c] + Pi[c] + H+[c]
HMR_0379	ATP[c] + DHA[c] + H2O[c] => ADP[c] + DHA[s] + Pi[c] + H+[c]
HMR_0383	(11Z,14Z,17Z)-eicosatrienoic acid[c] + ATP[c] + H2O[c] => (11Z,14Z,17Z)-eicosatrienoic acid[s] + ADP[c] + Pi[c] + H+[c]
HMR_0387	13,16,19-docosatrienoic acid[c] + ATP[c] + H2O[c] => 13,16,19-docosatrienoic acid[s] + ADP[c] + Pi[c] + H+[c]
HMR_0391	10,13,16,19-docosatetraenoic acid[c] + ATP[c] + H2O[c] => 10,13,16,19-docosatetraenoic acid[s] + ADP[c] + Pi[c] + H+[c]
HMR_0395	12,15,18,21-tetracosatetraenoic acid[c] + ATP[c] + H2O[c] => 12,15,18,21-tetracosatetraenoic acid[s] + ADP[c] + Pi[c] + H+[c]
HMR_0399	ATP[c] + H2O[c] + linoleate[c] => ADP[c] + linoleate[s] + Pi[c] + H+[c]
HMR_0403	ATP[c] + gamma-linolenate[c] + H2O[c] => ADP[c] + gamma-linolenate[s] + Pi[c] + H+[c]
HMR_0407	ATP[c] + dihomo-gamma-linolenate[c] + H2O[c] => ADP[c] + dihomo-gamma-linolenate[s] + Pi[c] + H+[c]
HMR_0411	arachidonate[c] + ATP[c] + H2O[c] => ADP[c] + arachidonate[s] + Pi[c] + H+[c]
HMR_0415	adrenic acid[c] + ATP[c] + H2O[c] => ADP[c] + adrenic acid[s] + Pi[c] + H+[c]
HMR_0419	(9Z,12Z,15Z,18Z)-TTA[c] + ATP[c] + H2O[c] => (9Z,12Z,15Z,18Z)-TTA[s] + ADP[c] + Pi[c] + H+[c]
HMR_0423	(6Z,9Z,12Z,15Z,18Z)-TPA[c] + ATP[c] + H2O[c] => (6Z,9Z,12Z,15Z,18Z)-TPA[s] + ADP[c] + Pi[c] + H+[c]
HMR_0427	(4Z,7Z,10Z,13Z,16Z)-DPA[c] + ATP[c] + H2O[c] => (4Z,7Z,10Z,13Z,16Z)-DPA[s] + ADP[c] + Pi[c] + H+[c]
HMR_0431	(11Z,14Z)-eicosadienoic acid[c] + ATP[c] + H2O[c] => (11Z,14Z)-eicosadienoic acid[s] + ADP[c] + Pi[c] + H+[c]
HMR_0435	(13Z,16Z)-docosadienoic acid[c] + ATP[c] + H2O[c] => (13Z,16Z)-docosadienoic acid[s] + ADP[c] + Pi[c] + H+[c]
HMR_0439	10,13,16-docosatriynoic acid[c] + ATP[c] + H2O[c] => 10,13,16-docosatriynoic acid[s] + ADP[c] + Pi[c] + H+[c]
HMR_0469	ATP[c] + H2O[c] + PE-LD pool[c] => ADP[c] + PE-LD pool[s] + Pi[c] + H+[c]
HMR_0470	ATP[c] + bile-PC pool[c] + H2O[c] => ADP[c] + bile-PC pool[s] + Pi[c] + H+[c]
HMR_0476	ATP[c] + H2O[c] + PC-LD pool[c] => ADP[c] + PC-LD pool[s] + Pi[c] + H+[c]
HMR_1910	ATP[r] + cholesterol[r] + H2O[r] => ADP[r] + cholesterol[c] + Pi[r] + H+[r]
HMR_1911	ATP[c] + cholesterol[c] + H2O[c] => ADP[c] + cholesterol[s] + Pi[c] + H+[c]
HMR_1913	2 ATP[c] + 2 H2O[c] + sulfate[c] => 2 ADP[c] + 2 Pi[c] + sulfate[s] + 2 H+[c]
HMR_5295	ATP[c] + H2O[c] + K+[s] + Na+[c] => ADP[c] + K+[c] + Na+[s] + Pi[c] + H+[c]
HMR_5332	ATP[c] + glutamate[c] + H2O[c] => ADP[c] + glutamate[s] + Pi[c] + H+[c]
HMR_5429	ATP[c] + H2O[c] + 2 K+[s] + 3 Na+[c] => ADP[c] + 2 K+[c] + 3 Na+[s] + Pi[c] + H+[c]
HMR_5442	ATP[c] + GSH[c] + H2O[c] => ADP[c] + GSH[s] + Pi[c] + H+[c]
HMR_5443	ATP[c] + glutathionyl-leukotriene C4[c] + H2O[c] => ADP[c] + glutathionyl-leukotriene C4[s] + Pi[c] + H+[c]
HMR_5444	ATP[c] + H2O[c] + S-glutathionyl-2-4-dinitrobenzene[c] => ADP[c] + Pi[c] + S-glutathionyl-2-4-dinitrobenzene[s] + H+[c]
HMR_5445	ATP[c] + H2O[c] + S-glutathionyl-ethacrynic acid[c] => ADP[c] + Pi[c] + S-glutathionyl-ethacrynic acid[s] + H+[c]
HMR_5446	ATP[c] + H2O[c] + urate[c] => ADP[c] + Pi[c] + urate[s] + H+[c]
HMR_6392	ATP[c] + H2O[c] + sulfotaurolithocholate[c] => ADP[c] + Pi[c] + sulfotaurolithocholate[s] + H+[c]
HMR_6406	ATP[c] + H2O[c] + lipoic acid[s] + 2 Na+[s] => ADP[c] + lipoic acid[c] + 2 Na+[c] + Pi[c] + H+[c]
HMR_7568	UDP-glucuronate[c] + UDP-N-acetylglucosamine[c] => hyaluronan biosynthesis, precursor 1[s] + 2 UDP[c] + 2 H+[c]
HMR_7569	hyaluronan biosynthesis, precursor 1[s] + UDP-glucuronate[c] + UDP-N-acetylglucosamine[c] => hyaluronate[s] + 2 UDP[c] + 2 H+[c]
HMR_7629	ATP[c] + 2 Ca2+[c] + H2O[c] => ADP[c] + 2 Ca2+[s] + Pi[c] + H+[c]
HMR_7633	2 ATP[c] + 2 H2O[c] + 3 histamine[c] => 2 ADP[c] + 3 histamine[s] + 2 Pi[c] + 2 H+[c]
HMR_7634	3 5-hydroxy-L-tryptophan[c] + 2 ATP[c] + 2 H2O[c] => 3 5-hydroxy-L-tryptophan[s] + 2 ADP[c] + 2 Pi[c] + 2 H+[c]
HMR_7635	3 adrenaline[c] + 2 ATP[c] + 2 H2O[c] => 2 ADP[c] + 3 adrenaline[s] + 2 Pi[c] + 2 H+[c]
HMR_7636	2 ATP[c] + 3 dopamine[c] + 2 H2O[c] => 2 ADP[c] + 3 dopamine[s] + 2 Pi[c] + 2 H+[c]
HMR_7637	2 ATP[c] + 2 H2O[c] + 3 noradrenaline[c] => 2 ADP[c] + 3 noradrenaline[s] + 2 Pi[c] + 2 H+[c]
HMR_7650	ATP[c] + estradiol-17beta 3-glucuronide[c] + H2O[c] => ADP[c] + estradiol-17beta 3-glucuronide[s] + Pi[c] + H+[c]
HMR_7667	ATP[c] + biotin[s] + H2O[c] + 2 Na+[s] => ADP[c] + biotin[c] + 2 Na+[c] + Pi[c] + H+[c]
HMR_7679	1-methylnicotinamide[c] + ATP[c] + H2O[c] => 1-methylnicotinamide[s] + ADP[c] + Pi[c] + H+[c]
HMR_7681	3 acetylcholine[c] + 2 ATP[c] + 2 H2O[c] => 3 acetylcholine[s] + 2 ADP[c] + 2 Pi[c] + 2 H+[c]
HMR_7691	ATP[c] + cAMP[c] + H2O[c] => ADP[c] + cAMP[s] + Pi[c] + H+[c]
HMR_7692	ATP[c] + cGMP[c] + H2O[c] => ADP[c] + cGMP[s] + Pi[c] + H+[c]
HMR_7736	ATP[c] + 3 beta-alanine[c] + H2O[c] => ADP[c] + 3 beta-alanine[s] + Pi[c] + H+[c]
HMR_7737	ATP[c] + 3 glycine[c] + H2O[c] => ADP[c] + 3 glycine[s] + Pi[c] + H+[c]
HMR_7738	3 4-aminobutyrate[c] + ATP[c] + H2O[c] => 3 4-aminobutyrate[s] + ADP[c] + Pi[c] + H+[c]
HMR_7964	ATP[c] + estrone-glucuronide[c] + H2O[c] => ADP[c] + estrone-glucuronide[s] + Pi[c] + H+[c]
HMR_7967	androsterone-glucuronide[c] + ATP[c] + H2O[c] => ADP[c] + androsterone-glucuronide[s] + Pi[c] + H+[c]
HMR_7982	ATP[c] + etiocholan-3alpha-ol-17-one 3-glucuronide[c] + H2O[c] => ADP[c] + etiocholan-3alpha-ol-17-one 3-glucuronide[s] + Pi[c] + H+[c]
HMR_7986	16-glucuronide-estriol[c] + ATP[c] + H2O[c] => 16-glucuronide-estriol[s] + ADP[c] + Pi[c] + H+[c]
HMR_7990	5alpha-dihydrotestosterone-glucuronide[c] + ATP[c] + H2O[c] => 5alpha-dihydrotestosterone-glucuronide[s] + ADP[c] + Pi[c] + H+[c]
HMR_8103	4-pyridoxate[c] + ATP[c] + H2O[c] => 4-pyridoxate[s] + ADP[c] + Pi[c] + H+[c]
HMR_8633	ATP[c] + bilirubin-monoglucuronoside[c] + H2O[c] => ADP[c] + bilirubin-monoglucuronoside[s] + Pi[c] + H+[c]
HMR_8730	ATP[c] + H2O[c] + riboflavin[s] => ADP[c] + Pi[c] + riboflavin[c] + H+[c]
HMR_8850	ATP[c] + H2O[c] + testosterone glucuronide[c] => ADP[c] + Pi[c] + testosterone glucuronide[s] + H+[c]
HMR_8892	ATP[c] + H2O[c] + K+[s] => ADP[c] + K+[c] + Pi[c] + H+[c]
HMR_8922	2 ATP[c] + 2 H2O[c] + 3 L-metanephrine[c] => 2 ADP[c] + 3 L-metanephrine[s] + 2 Pi[c] + 2 H+[c]
HMR_8923	ATP[c] + H2O[c] + phylloquinone[s] => ADP[c] + phylloquinone[c] + Pi[c] + H+[c]
HMR_8930	ATP[c] + H2O[c] + 2 Na+[s] + pantothenate[s] => ADP[c] + 2 Na+[c] + pantothenate[c] + Pi[c] + H+[c]
HMR_8934	ATP[c] + H2O[c] + prostaglandin E1[c] => ADP[c] + Pi[c] + prostaglandin E1[s] + H+[c]
HMR_8935	ATP[c] + H2O[c] + prostaglandin E2[c] => ADP[c] + Pi[c] + prostaglandin E2[s] + H+[c]
HMR_3008	ATP[c] + H2O[c] + propanoyl-CoA[c] => ADP[c] + Pi[c] + propanoyl-CoA[p] + H+[c]
HMR_3011	ATP[c] + H2O[c] + palmitoyl-CoA[c] => ADP[c] + palmitoyl-CoA[p] + Pi[c] + H+[c]
HMR_3013	ATP[c] + H2O[c] + linoleoyl-CoA[c] => ADP[c] + linoleoyl-CoA[p] + Pi[c] + H+[c]
HMR_3014	arachidonyl-CoA[c] + ATP[c] + H2O[c] => ADP[c] + arachidonyl-CoA[p] + Pi[c] + H+[c]
HMR_3017	(13Z)-eicosenoyl-CoA[c] + ATP[c] + H2O[c] => (13Z)-eicosenoyl-CoA[p] + ADP[c] + Pi[c] + H+[c]
HMR_7799	ATP[c] + 3 H+[c] + H2O[c] => ADP[c] + 4 H+[l] + Pi[c]
HMR_8661	ATP[c] + cholesterol[g] + H2O[c] => ADP[c] + cholesterol[c] + Pi[c] + H+[c]
HMR_6741	ascorbate[c] + dopamine[c] + O2[c] => dehydroascorbic acid[c] + H2O[c] + noradrenaline[c]
HMR_1420	7-hydroperoxy-H4-neuroprostane[c] + ascorbate[c] <=> 7-hydroxy-E4-neuroprostane[c] + dehydroascorbic acid[c] + H2O[c]
HMR_1421	7-hydroperoxy-H4-neuroprostane[c] + ascorbate[c] <=> 7-hydroxy-D4-neuroprostane[c] + dehydroascorbic acid[c] + H2O[c]
HMR_1422	10-hydroperoxy-H4-neuroprostane[c] + ascorbate[c] <=> 10-hydroxy-E4-neuroprostane[c] + dehydroascorbic acid[c] + H2O[c]
HMR_1423	10-hydroperoxy-H4-neuroprostane[c] + ascorbate[c] <=> 10-hydroxy-D4-neuroprostane[c] + dehydroascorbic acid[c] + H2O[c]
HMR_1424	11-hydroperoxy-H4-neuroprostane[c] + ascorbate[c] <=> 11-hydroxy-E4-neuroprostane[c] + dehydroascorbic acid[c] + H2O[c]
HMR_1425	11-hydroperoxy-H4-neuroprostane[c] + ascorbate[c] <=> 11-hydroxy-D4-neuroprostane[c] + dehydroascorbic acid[c] + H2O[c]
HMR_1426	13-hydroperoxy-H4-neuroprostane[c] + ascorbate[c] <=> 13-hydroxy-E4-neuroprostane[c] + dehydroascorbic acid[c] + H2O[c]
HMR_1428	14-hydroperoxy-H4-neuroprostane[c] + ascorbate[c] <=> 14-hydroxy-E4-neuroprostane[c] + dehydroascorbic acid[c] + H2O[c]
HMR_1429	14-hydroperoxy-H4-neuroprostane[c] + ascorbate[c] <=> 14-hydroxy-D4-neuroprostane[c] + dehydroascorbic acid[c] + H2O[c]
HMR_1432	20-hydroperoxy-H4-neuroprostane[c] + ascorbate[c] <=> 20-hydroxy-D4-neuroprostane[c] + dehydroascorbic acid[c] + H2O[c]
HMR_1433	20-hydroperoxy-H4-neuroprostane[c] + ascorbate[c] <=> 20-hydroxy-E4-neuroprostane[c] + dehydroascorbic acid[c] + H2O[c]
HMR_6396	dehydroascorbic acid[c] + NADPH[c] + H+[c] => ascorbate[c] + NADP+[c]
HMR_8619	ascorbate[c] + 2 H+[c] + 2 O2-[c] => dehydroascorbic acid[c] + 2 H2O2[c]
HMR_8620	dehydroascorbic acid[c] + 2 GSH[c] => ascorbate[c] + GSSG[c]
HMR_8621	dehydroascorbic acid[c] + H2O[c] => 2,3-diketo-L-gulonate[c]
HMR_6395	ascorbate[s] + 2 Fe3+[s] => dehydroascorbic acid[s] + 2 Fe2+[s] + 2 H+[s]
HMR_9542	dehydroascorbic acid[c] + H2O[c] + peptidylamidoglycolate[c] <=> ascorbate[c] + O2[c] + peptidylglycine[c]
TTDCPT2	CoA[m] + tetradecanoylcarnitine[m] <=> L-carnitine[m] + myristoyl-CoA[m]
RE2911C	NADPH[c] + 1-Acylglycerone 3-Phosphate[c] + H+[c] => NADP+[c] + Lysophosphatidic Acid[c]
RE3450C	9,11-cycloperoxy-5-hydroperoxy-(6E,14Z)-eicosadienoate[c] + 2 ascorbate[c] => 5,9,11-trihydroxyprosta-(6E,14Z)-dien-1-oate[c] + 2 dehydroascorbic acid[c] + H2O[c]
RE3456C	5,9-cyclo-6,8-cycloperoxy-12-hydroperoxy-(10E,14Z)-eicosadienoate[c] + 2 ascorbate[c] => 5,9-cyclo-6,8,12-trihydroxy-(10E,14Z)-eicosadienoic acid[c] + 2 dehydroascorbic acid[c] + H2O[c]
C140CPT1	L-carnitine[c] + myristoyl-CoA[c] <=> CoA[c] + tetradecanoylcarnitine[c]
FAOXC16OHC16r	NADPH[r] + O2[r] + palmitate[r] + H+[r] => H2O[r] + NADP+[r] + 16-hydroxyhexadecanoic acid[r]
FAOXOHC16C16DCc	16-hydroxyhexadecanoic acid[c] + H2O[c] + 2 NAD+[c] => 3 H+[c] + 2 NADH[c] + Hexadecanediocacid[c]
HMR_6398	ATP[c] + lipoic acid[c] + H+[c] => lipoyl-AMP[c] + PPi[c]
HMR_6405	H2O[c] + lipoyllysine[c] <=> lipoic acid[c] + lysine[c]
FAOXC11	CoA[m] + H2O[m] + NAD+[m] + 4,8-Dimethylnonanoyl Coenzyme A[m] => acetyl-CoA[m] + 3 H+[m] + NADH[m] + 2,6-Dimethylheptanoyl Coenzyme A[m]
PEROXx	3 CoA[p] + 3 H2O[p] + 3 NAD+[p] + 2 O2[p] + Pristanoyl Coenzyme A[p] => acetyl-CoA[p] + 5 H+[p] + 2 H2O2[p] + 3 NADH[p] + 2 propanoyl-CoA[p] + 4,8-Dimethylnonanoyl Coenzyme A[p]
FAOXC11BRC9BRx	CoA[p] + H2O[p] + NAD+[p] + O2[p] + 2,6,10-Trimethyl Undecanoyl Coenzyme A[p] => H2O2[p] + NADH[p] + propanoyl-CoA[p] + 4,8-Dimethylnonanoyl Coenzyme A[p] + H+[p]
FAOXC9BRC7BRm	CoA[m] + FAD[m] + H2O[m] + NAD+[m] + 4,8-Dimethylnonanoyl Coenzyme A[m] => acetyl-CoA[m] + FADH2[m] + H+[m] + NADH[m] + 2,6-Dimethyl Heptanoyl Coenzyme A[m]
RE2898C	monodehydroascorbate[c] => dehydroascorbic acid[c] + H+[c]
HMR_7163	DNA[c] + H2O[c] => 0.3 dAMP[c] + 0.2 dCMP[c] + 0.2 dGMP[c] + 0.3 dTMP[c] + H+[c]
HMR_7164	H2O[c] + RNA[c] => 0.18 AMP[c] + 0.3 CMP[c] + 0.34 GMP[c] + 0.18 UMP[c] + H+[c]
r0701	HMA[c] + NADP+[c] => 3-oxotetradecanoyl-[ACP][c] + NADPH[c] + H+[c]
r1317	H2O[c] + Stearoyl-ACP[c] => [ACP][c] + stearate[c] + H+[c]
r1254	ATP[c] + CoA[c] + stearate[c] => AMP[c] + PPi[c] + stearoyl-CoA[c]
HMR_6432	13-carboxy-alpha-tocotrienol[m] + ATP[m] + CoA[m] + 2 H2O[m] + NAD+[m] => 11-carboxy-alpha-tocotrienol[m] + AMP[m] + 2 H+[m] + NADH[m] + PPi[m] + propanoyl-CoA[m]
HMR_6433	11-carboxy-alpha-tocotrienol[m] + ATP[m] + CoA[m] + 2 H2O[m] + NAD+[m] + O2[m] => 9-carboxy-alpha-tocotrienol[m] + acetyl-CoA[m] + AMP[m] + H2O2[m] + NADH[m] + PPi[m] + 2 H+[m]
HMR_6434	9-carboxy-alpha-tocotrienol[m] + ATP[m] + CoA[m] + 2 H2O[m] + NAD+[m] => 7-carboxy-alpha-tocotrienol[m] + AMP[m] + 2 H+[m] + NADH[m] + PPi[m] + propanoyl-CoA[m]
HMR_6435	7-carboxy-alpha-tocotrienol[m] + ATP[m] + CoA[m] + 2 H2O[m] + O2[m] => 5-carboxy-alpha-chromanol[m] + acetyl-CoA[m] + AMP[m] + H2O2[m] + PPi[m] + H+[m]
HMR_6436	5-carboxy-alpha-chromanol[m] + ATP[m] + CoA[m] + 2 H2O[m] + NAD+[m] + O2[m] => 3-carboxy-alpha-chromanol[m] + AMP[m] + 2 H+[m] + H2O2[m] + NADH[m] + PPi[m] + propanoyl-CoA[m]
HMR_6447	13-carboxy-gamma-tocotrienol[m] + ATP[m] + CoA[m] + 2 H2O[m] + NAD+[m] => 11-carboxy-gamma-tocotrienol[m] + AMP[m] + NADH[m] + PPi[m] + propanoyl-CoA[m] + 2 H+[m]
HMR_6448	11-carboxy-gamma-tocotrienol[m] + ATP[m] + CoA[m] + 2 H2O[m] + NAD+[m] + O2[m] => 9-carboxy-gamma-tocotrienol[m] + acetyl-CoA[m] + AMP[m] + H2O2[m] + NADH[m] + PPi[m] + 2 H+[m]
HMR_6450	9-carboxy-gamma-tocotrienol[m] + ATP[m] + CoA[m] + 2 H2O[m] + NAD+[m] => 7-carboxy-gamma-tocotrienol[m] + AMP[m] + NADH[m] + PPi[m] + propanoyl-CoA[m] + 2 H+[m]
HMR_6451	7-carboxy-gamma-tocotrienol[m] + ATP[m] + CoA[m] + 2 H2O[m] + O2[m] => 5-carboxy-gamma-chromanol[m] + acetyl-CoA[m] + AMP[m] + H2O2[m] + PPi[m] + H+[m]
HMR_6453	5-carboxy-gamma-chromanol[m] + ATP[m] + CoA[m] + 2 H2O[m] + NAD+[m] + O2[m] => AMP[m] + gamma-carboxyethyl-hydroxychroman[m] + H2O2[m] + NADH[m] + PPi[m] + propanoyl-CoA[m] + 2 H+[m]
HMR_6470	13-carboxy-gamma-tocopherol[m] + ATP[m] + CoA[m] + 2 H2O[m] + NAD+[m] + O2[m] => 11-carboxy-gamma-chromanol[m] + AMP[m] + H2O2[m] + NADH[m] + PPi[m] + propanoyl-CoA[m] + 2 H+[m]
HMR_6471	11-carboxy-gamma-chromanol[m] + ATP[m] + CoA[m] + 2 H2O[m] + NAD+[m] + O2[m] => 9-carboxy-gamma-chromanol[m] + acetyl-CoA[m] + AMP[m] + H2O2[m] + NADH[m] + PPi[m] + 2 H+[m]
HMR_6472	9-carboxy-gamma-chromanol[m] + ATP[m] + CoA[m] + 2 H2O[m] + NAD+[m] + O2[m] => 7-carboxy-gamma-chromanol[m] + AMP[m] + H2O2[m] + NADH[m] + PPi[m] + propanoyl-CoA[m] + 2 H+[m]
HMR_6473	7-carboxy-gamma-chromanol[m] + ATP[m] + CoA[m] + 2 H2O[m] + NAD+[m] + O2[m] => 5-carboxy-gamma-chromanol[m] + acetyl-CoA[m] + AMP[m] + H2O2[m] + NADH[m] + PPi[m] + 2 H+[m]
HMR_6482	13-carboxy-alpha-tocopherol[m] + ATP[m] + CoA[m] + 2 H2O[m] + NAD+[m] + O2[m] => 11-carboxy-alpha-chromanol[m] + AMP[m] + H2O2[m] + NADH[m] + PPi[m] + propanoyl-CoA[m] + 2 H+[m]
HMR_6484	11-carboxy-alpha-chromanol[m] + ATP[m] + CoA[m] + 2 H2O[m] + NAD+[m] + O2[m] => 9-carboxy-alpha-chromanol[m] + acetyl-CoA[m] + AMP[m] + H2O2[m] + NADH[m] + PPi[m] + 2 H+[m]
HMR_6486	9-carboxy-alpha-chromanol[m] + ATP[m] + CoA[m] + 2 H2O[m] + NAD+[m] + O2[m] => 7-carboxy-alpha-chromanol[m] + AMP[m] + H2O2[m] + NADH[m] + PPi[m] + propanoyl-CoA[m] + 2 H+[m]
HMR_6488	7-carboxy-alpha-chromanol[m] + ATP[m] + CoA[m] + 2 H2O[m] + NAD+[m] + O2[m] => 5-carboxy-alpha-chromanol[m] + acetyl-CoA[m] + AMP[m] + H2O2[m] + NADH[m] + PPi[m] + 2 H+[m]
HMR_2061	2-hydroxyestrone[c] + H2O2[c] + H+[c] <=> estrone-2,3-semiquinone[c] + 2 H2O[c]
HMR_2062	2-hydroxyestrone[l] + H2O2[l] + H+[l] <=> estrone-2,3-semiquinone[l] + 2 H2O[l]
HMR_2063	2-hydroxyestrone[r] + H2O2[r] + H+[r] <=> estrone-2,3-semiquinone[r] + 2 H2O[r]
HMR_2076	4-hydroxyestrone[c] + H2O2[c] + H+[c] <=> estrone-3,4-semiquinone[c] + 2 H2O[c]
HMR_2077	4-hydroxyestrone[l] + H2O2[l] + H+[l] <=> estrone-3,4-semiquinone[l] + 2 H2O[l]
HMR_2078	4-hydroxyestrone[r] + H2O2[r] + H+[r] <=> estrone-3,4-semiquinone[r] + 2 H2O[r]
HMR_2064	estrone-2,3-semiquinone[c] + O2[c] => estrone-2,3-quinone[c] + O2-[c] + H+[c]
HMR_2079	estrone-3,4-semiquinone[c] + O2[c] => estrone-3,4-quinone[c] + O2-[c] + H+[c]
HMR_2099	17beta-estradiol-2,3-semiquinone[c] + 2 H2O[c] <=> 2-hydroxyestradiol-17beta[c] + H2O2[c] + H+[c]
HMR_2100	17beta-estradiol-2,3-semiquinone[l] + 2 H2O[l] <=> 2-hydroxyestradiol-17beta[l] + H2O2[l] + H+[l]
HMR_2102	17beta-estradiol-2,3-semiquinone[c] + O2[c] => 17beta-estradiol-2,3-quinone[c] + O2-[c] + H+[c]
HMR_4241	histone-N6-methyl-L-lysine[n] + SAH[n] + H+[n] <=> histone-L-lysine[n] + SAM[n]
HMR_6974	lysine[c] + [protein][c] => [protein]-L-lysine[c] + H2O[c]
HMR_6975	[protein]-L-lysine[c] + SAM[c] => [protein]-N6-methyl-L-lysine[c] + SAH[c] + H+[c]
HMR_6976	[protein]-N6-methyl-L-lysine[c] + SAM[c] => [protein]-N6,N6-dimethyl-L-lysine[c] + SAH[c] + H+[c]
HMR_6977	[protein]-N6,N6-dimethyl-L-lysine[c] + SAM[c] => [protein]-N6,N6,N6-trimethyl-L-lysine[c] + SAH[c] + H+[c]
HMR_6978	[protein]-N6,N6,N6-trimethyl-L-lysine[c] + H2O[c] => H+[c] + N6,N6,N6-trimethyl-L-lysine[c] + [protein][c]
HMR_6983	[protein]-L-lysine[c] + AKG[c] + O2[c] => CO2[c] + procollagen-5-hydroxy-L-lysine[c] + succinate[c]
HMR_8029	[protein]-N6,N6,N6-trimethyl-L-lysine[r] + H2O[r] => H+[r] + N6,N6,N6-trimethyl-L-lysine[r] + [protein][r]
HMR_9578	H2O[c] + phosphoprotein[c] => [protein][c] + Pi[c] + H+[c]
HMR_8025	[protein]-L-lysine[n] + SAM[n] => histone-N6-methyl-L-lysine[n] + SAH[n] + H+[n]
HMR_9490	H2O[c] + ubiquitin C terminal thiolester[c] => thiol[c] + ubiquitin[c] + H+[c]
HMR_9495	CoA[c] + histone-N6-acetyl-L-lysine[c] + H+[c] <=> acetyl-CoA[c] + histone-L-lysine[c]
HMR_8026	histone-N6-methyl-L-lysine[n] + SAM[n] => [protein]-N6,N6-dimethyl-L-lysine[n] + SAH[n] + H+[n]
HMR_8027	[protein]-N6,N6-dimethyl-L-lysine[n] + SAM[n] => [protein]-N6,N6,N6-trimethyl-L-lysine[n] + SAH[n] + H+[n]
HMR_9508	(5)ppPur-mRNA[c] + GTP[c] <=> G(5)pppR-RNA[c] + PPi[c]
HMR_9546	AMP[c] + PPi[c] + RNA-terminal-2,3-cyclic-phosphate[c] <=> ATP[c] + RNA-3-terminal-phosphate[c]
HMR_6636	H2O[c] + retinyl-ester[c] => fatty acid pool[c] + retinol[c] + H+[c]
HMR_6637	H2O[c] + retinyl-ester[c] => 11-cis-retinol[c] + fatty acid pool[c] + H+[c]
HMR_0305	(5Z,8Z,11Z)-eicosatrienoyl-CoA[c] + AMP[c] + PPi[c] <=> ATP[c] + CoA[c] + mead acid[c]
HMR_0306	(5Z,8Z,11Z)-eicosatrienoyl-CoA[c] + H2O[c] => CoA[c] + mead acid[c] + H+[c]
HMR_2971	(5Z,8Z,11Z)-eicosatrienoyl-CoA[r] + AMP[r] + PPi[r] <=> ATP[r] + CoA[r] + mead acid[r]
HMR_0490	(7Z)-tetradecenoyl-CoA[c] + sn-glycerol-3-phosphate[c] => 1-acylglycerol-3P-7-tetrade[c] + CoA[c]
HMR_0645	1-acyl-PE pool[c] + H2O[c] => sn-glycerol-3-PE[c] + fatty acid pool[c] + H+[c]
HMR_0005	1-acylglycerol-chylomicron pool[c] + H2O[c] => fatty acid-chylomicron pool[c] + glycerol[c]
HMR_0680	1-acylglycerol-LD-PC pool[c] + H2O[c] => glycerol[c] + fatty acid pool[c] + H+[c]
HMR_0681	1-acylglycerol-LD-PE pool[c] + H2O[c] => glycerol[c] + fatty acid pool[c] + H+[c]
HMR_0683	1-acylglycerol-LD-PI pool[c] + H2O[c] => glycerol[c] + fatty acid pool[c] + H+[c]
HMR_0682	1-acylglycerol-LD-PS pool[c] + H2O[c] => glycerol[c] + fatty acid pool[c] + H+[c]
HMR_0684	1-acylglycerol-LD-SM pool[c] + H2O[c] => glycerol[c] + fatty acid pool[c] + H+[c]
HMR_0673	1-acylglycerol-LD-TG1 pool[c] + ATP[c] => ADP[c] + 1-acylglycerol-3P pool[c] + H+[c]
HMR_0679	1-acylglycerol-LD-TG1 pool[c] + H2O[c] => glycerol[c] + fatty acid pool[c] + H+[c]
HMR_0010	1-acylglycerol-VLDL pool[c] + H2O[c] => fatty acid-VLDL pool[c] + glycerol[c]
HMR_7604	1-alkenyl-2-acylglycerol[c] + CDP-ethanolamine[c] <=> CMP[c] + O-1-alk-1-enyl-2-acyl-sn-glycero-3-phosphoethanolamine[c] + H+[c]
HMR_7599	1-alkyl-2-acylglycerol[c] + CDP-ethanolamine[c] => 1-alkyl-2-acylglycerophosphoethanolamine[c] + CMP[c] + H+[c]
HMR_6544	1-phosphatidyl-1D-myo-inositol-3-phosphate[c] + ATP[c] => 1-phosphatidyl-myo-inositol-3,5-bisphosphate[c] + ADP[c] + H+[c]
HMR_8822	1-phosphatidyl-1D-myo-inositol-4-phosphate[c] + H2O[c] => 1,2-diacylglycerol-LD-PI pool[c] + 1D-myo-inositol-1,4-bisphosphate[c] + H+[c]
HMR_8823	1-phosphatidyl-1D-myo-inositol-4-phosphate[n] + H2O[n] => 1,2-diacylglycerol-LD-PI pool[n] + 1D-myo-inositol-1,4-bisphosphate[n] + H+[n]
HMR_6554	1-phosphatidyl-1D-myo-inositol-5-phosphate[c] + ATP[c] => ADP[c] + phosphatidylinositol-4,5-bisphosphate[c] + H+[c]
HMR_8826	1-phosphatidyl-1D-myo-inositol-5-phosphate[n] + ATP[n] => ADP[n] + phosphatidylinositol-4,5-bisphosphate[n] + H+[n]
HMR_8522	1-radyl-2-acyl-sn-glycero-3-phosphocholine[c] + H2O[c] => 1-alkyl-2-lysoglycerol-3-phosphocholine[c] + fatty acid pool[c] + H+[c]
HMR_0468	1,2-diacylglycerol-bile-PC pool[c] + CDP-choline[c] => bile-PC pool[c] + CMP[c] + H+[c]
HMR_0625	1,2-diacylglycerol-LD-PC pool[c] + CDP-choline[c] => CMP[c] + PC-LD pool[c] + H+[c]
HMR_0669	1,2-diacylglycerol-LD-PC pool[c] + H2O[c] => 1-acylglycerol-LD-PC pool[c] + fatty acid pool[c] + H+[c]
HMR_0614	1,2-diacylglycerol-LD-PE pool[c] + CDP-ethanolamine[c] => CMP[c] + PE-LD pool[c] + H+[c]
HMR_0670	1,2-diacylglycerol-LD-PE pool[c] + H2O[c] => 1-acylglycerol-LD-PE pool[c] + fatty acid pool[c] + H+[c]
HMR_0668	1,2-diacylglycerol-LD-PI pool[c] + H2O[c] => 1-acylglycerol-LD-PI pool[c] + fatty acid pool[c] + H+[c]
HMR_0671	1,2-diacylglycerol-LD-PS pool[c] + H2O[c] => 1-acylglycerol-LD-PS pool[c] + fatty acid pool[c] + H+[c]
HMR_0672	1,2-diacylglycerol-LD-SM pool[c] + H2O[c] => 1-acylglycerol-LD-SM pool[c] + fatty acid pool[c] + H+[c]
HMR_0667	1,2-diacylglycerol-LD-TAG pool[c] + H2O[c] => 1-acylglycerol-LD-TG1 pool[c] + fatty acid pool[c] + H+[c]
LRAT1	11-cis-retinol[c] + PC-LD pool[c] => 2-lysolecithin pool[c] + retinyl-ester[c]
HMR_6639	11-cis-retinol[c] + PC-LD pool[c] => retinyl-ester[c] + 1-lysolecithin pool[c]
HMR_5244	165 2-lysolecithin pool[r] + apoB100[r] + 7 apoE[r] + 500 cholesterol[r] + 1645 cholesterol-ester pool[r] + 2165 PC-LD pool[r] + 185 PE-LD pool[r] + PI pool[r] + 755 SM pool[r] + 10385 TAG-VLDL pool[r] + H+[r] => VLDL[r]
HMR_8835	1D-myo-inositol-bisdiphosphate-tetrakisphosphate[c] + 2 H2O[c] => 1D-myo-inositol-1,3,4,5,6-pentakisphosphate[c] + Pi[c] + PPi[c] + H+[c]
HMR_8836	1D-myo-inositol-bisdiphosphate-tetrakisphosphate[n] + 2 H2O[n] => 1D-myo-inositol-1,3,4,5,6-pentakisphosphate[n] + Pi[n] + PPi[n] + H+[n]
HMR_5234	2 apoA1[r] + 20 cholesterol[r] + 160 cholesterol-ester pool[r] + 90 PC-LD pool[r] + 25 PE-LD pool[r] + 30 PS-LD pool[r] + 75 SM pool[r] + 30 H+[r] => HDL[r]
HMR_0477	2 bile-PC pool[s] + PC-LD pool[s] + PE-LD pool[s] => phospholipids extracellular pool[s]
HMR_0633	2-lysolecithin pool[c] + H2O[c] => sn-glycerol-3-PC[c] + fatty acid pool[c] + H+[c]
HMR_5239	25 2-lysolecithin pool[r] + apoB100[r] + 110 CDP-diacylglycerol-LD-PI pool[r] + 680 cholesterol[r] + 1515 cholesterol-ester pool[r] + 425 PC-LD pool[r] + 30 PE-LD pool[r] + 160 SM pool[r] + 220 H+[r] => LDL[r]
HMR_7188	6-(alpha-D-glucosaminyl)-1-phosphatidyl-1D-myo-inositol[r] + H2O[r] => 6-(alpha-D-glucosaminyl)-1D-myo-inositol[r] + 2 H+[r] + phosphatidate-LD-PI pool[r]
HMR_6693	A2PE[c] + H2O[c] <=> N-retinylidene-N-retinylethanolamine[c] + phosphatidate-LD-PE pool[c] + H+[c]
HMR_7594	acylglycerone-phosphate[p] + Hydroxy Alkyl Chain[p] => alkyl-glycerone-3-phosphate[p] + fatty acid pool[p] + H+[p]
AGPSx	acylglycerone-phosphate[p] + Hydroxy Alkyl Chain[p] => alkyl-glycerone-3-phosphate[p] + H+[p] + R Total[p]
HMR_7597	alkyl-glycerone-3-phosphate[c] + fatty acid pool[c] + NADPH[c] + 2 H+[c] => 2-acyl-1-alkyl-sn-glycero-3-phosphate[c] + NADP+[c] + H2O[c]
HMR_6579	ATP[c] + PI pool[c] => 1-phosphatidyl-1D-myo-inositol-5-phosphate[c] + ADP[c] + H+[c]
HMR_6580	ATP[g] + PI pool[g] => 1-phosphatidyl-1D-myo-inositol-5-phosphate[g] + ADP[g] + H+[g]
HMR_8831	ATP[n] + PI pool[n] => 1-phosphatidyl-1D-myo-inositol-5-phosphate[n] + ADP[n] + H+[n]
HMR_6581	ATP[r] + PI pool[r] => 1-phosphatidyl-1D-myo-inositol-5-phosphate[r] + ADP[r] + H+[r]
CLS_hs	CDP-diacylglycerol-CL pool[c] + PG-CL pool[c] => CL pool[c] + CMP[c] + H+[c]
PGPPT	CDP-diacylglycerol-CL pool[c] + sn-glycerol-3-phosphate[c] => CMP[c] + H+[c] + PGP-CL pool[c]
HMR_0586	CDP-diacylglycerol-CL pool[m] + PG-CL pool[m] => CL pool[m] + CMP[m] + H+[m]
HMR_0582	CDP-diacylglycerol-CL pool[m] + sn-glycerol-3-phosphate[m] => CMP[m] + PGP-CL pool[m] + H+[m]
HMR_0607	CDP-diacylglycerol-LD-PI pool[c] + PPi[c] <=> CTP[c] + phosphatidate-LD-PI pool[c] + H+[c]
HMR_0736	ceramide pool[c] + PC-LD pool[c] => 1,2-diacylglycerol-LD-PC pool[c] + SM pool[c]
HMR_0735	ceramide pool[g] + PC-LD pool[g] => 1,2-diacylglycerol-LD-PC pool[g] + SM pool[g]
HMR_8211	ceramide pool[l] + H2O[l] => sphingosine[l] + fatty acid pool[l]
SMSn	ceramide pool[n] + PC-LD pool[n] => 1,2-diacylglycerol-LD-PC pool[n] + SM pool[n]
HMR_3564	cholesterol-ester-5,8,11-eico[l] + H2O[l] => cholesterol[l] + mead acid[l] + H+[l]
HMR_3710	cholesterol-ester-5,8,11-eico[r] + H2O[r] => cholesterol[r] + mead acid[r] + H+[r]
HMR_5247	chylomicron remnant[l] => 2-lysolecithin pool[l] + apoB48[l] + apoE[l] + 2 cholesterol[l] + 3 cholesterol-ester pool[l] + PC-LD pool[l] + PE-LD pool[l] + PI pool[l] + PS-LD pool[l] + SM pool[l] + 90 TAG-chylomicron pool[l] + 2 H+[l]
HMR_0616	CO2[c] + PE-PS-LD pool[c] => PS-LD pool[c] + H+[c]
CDS	CTP[c] + H+[c] + phosphatidate-LD-PI pool[c] => CDP-diacylglycerol-LD-PI pool[c] + PPi[c]
CDSm	CTP[m] + H+[m] + phosphatidate-LD-PI pool[m] => PPi[m] + CDP-diacylglycerol-LD-PI pool[m]
HMR_0753	dihydroceramide pool[c] + H2O[c] <=> sphinganine[c] + fatty acid pool[c]
HMR_9552	diphospho-myo-inositol-polyphosphate[c] + H2O[c] => myo-inositol-polyphosphate[c] + Pi[c] + H+[c]
H8MTer_U	dolichyl-phosphate-D-mannose[r] + gpi heparan sulfate[r] => dolichyl-phosphate[r] + H+[r] + Mannosyl-3-(Phosphoethanolaminyl-Mannosyl)-Glucosaminyl-Acylphosphatidylinositol (M4A))[r]
HMR_8720	fatty acid pool[c] => fatty acid pool[s]
HMR_9209	fatty acid pool[s] <=> fatty acid pool[x]
HMR_7603	H2O[c] + O-1-alk-1-enyl-2-acyl-sn-glycero-3-phosphoethanolamine[c] => 1-(1-alkenyl)-sn-glycero-3-phosphoethanolamine[c] + fatty acid pool[c] + H+[c]
HMR_7605	H2O[c] + O-1-alk-1-enyl-2-acyl-sn-glycero-3-phosphoethanolamine[c] => 2-acyl-1-(1-alkenyl)-sn-glycero-3-phosphate[c] + ethanolamine[c] + H+[c]
HMR_0630	H2O[c] + PC-LD pool[c] => 2-lysolecithin pool[c] + fatty acid pool[c] + H+[c]
HMR_0629	H2O[c] + PC-LD pool[c] => choline[c] + phosphatidate-LD-PC pool[c] + H+[c]
HMR_0643	H2O[c] + PE-LD pool[c] => 1-acyl-PE pool[c] + fatty acid pool[c] + H+[c]
HMR_0642	H2O[c] + PE-LD pool[c] => ethanolamine[c] + phosphatidate-LD-PE pool[c] + H+[c]
RE3268C	H2O[c] + phosphatidylinositol-3,4,5-trisphosphate[c] => phosphatidylinositol-3,5-bisphosphate[c] + Pi[c]
HMR_6559	H2O[c] + phosphatidylinositol-4,5-bisphosphate[c] => 1,2-diacylglycerol-LD-PI pool[c] + D-myo-inositol-1,4,5-trisphosphate[c] + H+[c]
HMR_0716	H2O[c] + phytoceramide pool[c] => phytosphingosine[c] + fatty acid pool[c]
HMR_8832	H2O[c] + PI pool[c] => 1,2-diacylglycerol-LD-PI pool[c] + H+[c] + inositol-1-phosphate[c]
HMR_0663	H2O[c] + PI pool[c] => 1,2-diacylglycerol-LD-PI pool[c] + inositol-1-phosphate[c] + H+[c]
RE3273C	H2O[c] + PI pool[c] => H+[c] + inositol[c] + phosphatidate-LD-PI pool[c]
RE3301C	H2O[c] + PS-LD pool[c] => H+[c] + phosphatidate-LD-PS pool[c] + serine[c]
HMR_0660	H2O[c] + PS-LD pool[c] => phosphatidate-LD-PS pool[c] + serine[c] + H+[c]
RETH	H2O[c] + retinyl-ester[c] => H+[c] + retinol[c] + R Total 2 Position[c]
HMR_8245	H2O[c] + SM pool[c] => sphingosylphosphorylcholine[c] + fatty acid pool[c]
HMR_0665	H2O[c] + TAG-LD pool[c] => 1,2-diacylglycerol-LD-TAG pool[c] + fatty acid pool[c] + H+[c]
HMR_8523	H2O[g] + PC-LD pool[g] => choline[g] + phosphatidate-LD-PC pool[g] + H+[g]
RE3273G	H2O[g] + PI pool[g] => H+[g] + phosphatidate-LD-PI pool[g] + inositol[g]
RE3301G	H2O[g] + PS-LD pool[g] => H+[g] + phosphatidate-LD-PS pool[g] + serine[g]
HMR_5254	H2O[l] + PC-LD pool[l] => 2-lysolecithin pool[l] + fatty acid pool[l] + H+[l]
PCHOLPm_hs	H2O[m] + PC-LD pool[m] => choline[m] + H+[m] + phosphatidate-LD-PC pool[m]
HMR_8818	H2O[n] + phosphatidylinositol-4,5-bisphosphate[n] => 1,2-diacylglycerol-LD-PI pool[n] + D-myo-inositol-1,4,5-trisphosphate[n] + H+[n]
HMR_8833	H2O[n] + PI pool[n] => 1,2-diacylglycerol-LD-PI pool[n] + H+[n] + inositol-1-phosphate[n]
HMR_0463	H2O[r] + PC-LD pool[r] => 2-lysolecithin pool[r] + fatty acid pool[r] + H+[r]
HMR_8525	H2O[r] + PC-LD pool[r] => choline[r] + phosphatidate-LD-PC pool[r] + H+[r]
RE3273R	H2O[r] + PI pool[r] => H+[r] + inositol[r] + phosphatidate-LD-PI pool[r]
RE3301R	H2O[r] + PS-LD pool[r] => H+[r] + phosphatidate-LD-PS pool[r] + serine[r]
RETHe	H2O[s] + retinyl-ester[s] => H+[s] + retinol[s] + R Total 2 Position[s]
HMR_5233	HDL remnant[l] => 2 apoA1[l] + 90 PC-LD pool[l] + 25 PE-LD pool[l] + 30 PS-LD pool[l] + 75 SM pool[l] + 30 H+[l]
HMR_5238	LDL remnant[l] => 25 2-lysolecithin pool[l] + apoB100[l] + 110 CDP-diacylglycerol-LD-PI pool[l] + 425 PC-LD pool[l] + 30 PE-LD pool[l] + 160 SM pool[l] + 220 H+[l]
M4BET2er	mem2emgacpail heparan sulfate[r] + PE-LD pool[r] => 1,2-diacylglycerol-LD-PE pool[r] + Mannosyl-3-(Phosphoethanolaminyl-Mannosyl)-Glucosaminyl-Acylphosphatidylinositol (M4A))[r]
LRAT	PC-LD pool[c] + retinol[c] => 2-lysolecithin pool[c] + retinyl-ester[c]
SMS21e	PC-LD pool[s] + ceramide pool[s] => 1,2-diacylglycerol-LD-PC pool[s] + SM pool[s]
HMR_0653	PE-LD pool[c] + SAM[c] => PE-NME-LD pool[c] + SAH[c] + H+[c]
HMR_0657	PPE-NME2-LD pool[c] + SAM[c] => PC-LD pool[c] + SAH[c] + H+[c]
RETFA	retinol[c] + R Total 2 Coenzyme A[c] => CoA[c] + retinyl-ester[c]
RETH2	retinyl-ester[c] + H2O[c] => 11-cis-retinol[c] + H+[c] + R Total 2 Position[c]
RETFAt	retinyl-ester[c] => retinyl-ester[s]
RETH2e	retinyl-ester[s] + H2O[s] => H+[s] + 11-cis-retinol[s] + R Total 2 Position[s]
EX_retfa[e]	retinyl-ester[s] <=> retinyl-ester[x]
HMR_5243	VLDL remnant[l] => 165 2-lysolecithin pool[l] + apoB100[l] + 7 apoE[l] + 500 cholesterol[l] + 1645 cholesterol-ester pool[l] + 2165 PC-LD pool[l] + 185 PE-LD pool[l] + PI pool[l] + 755 SM pool[l] + H+[l]
HMR_5128	NH4+[s] <=> H+[s] + NH3[s]
HMR_5127	NH4+[c] <=> H+[c] + NH3[c]
HMR_7282	asparagine[c] + [protein][c] => [protein]-L-asparagine[c] + H2O[c]
HMR_7616	tyrosine[c] + [protein][c] => [protein]-L-tyrosine[c] + H2O[c]
HMR_7617	[protein]-L-tyrosine[c] + ATP[c] => [protein]-tyrosine-phosphate[c] + ADP[c] + H+[c]
HMR_7619	[protein]-L-tyrosine[c] + PAPS[c] <=> [protein]-tyrosine-O-sulfate[c] + PAP[c] + H+[c]
HMR_7621	arginine[c] + [protein][c] => [protein]-L-arginine[c] + H2O[c]
HMR_7625	[protein]-L-arginine[c] + H2O[c] + NAD+[c] => N(omega)-(ADP-D-ribosyl)-L-arginine[c] + nicotinamide[c] + [protein][c] + H+[c]
HMR_7622	[protein]-L-arginine[c] + H2O[c] => [protein]-L-citrulline[c] + NH4+[c]
HMR_9735	[protein]-L-citrulline[c] + H2O[c] => citrulline[c] + [protein][c]
HMR_0820	CMP-N-acetylneuraminate[c] + GA1[c] => CMP[c] + GM1[c] + H+[c]
HMR_0849	CMP-N-acetylneuraminate[c] + GA2[c] => CMP[c] + GM2[c] + H+[c]
HMR_0837	CMP-N-acetylneuraminate[c] + GM1[c] => CMP[c] + GD1a[c] + H+[c]
HMR_0852	CMP-N-acetylneuraminate[c] + GM1[c] => CMP[c] + GD1b[c] + H+[c]
HMR_0851	CMP-N-acetylneuraminate[c] + GM2[c] => CMP[c] + GD2[c] + H+[c]
HMR_8188	CMP-N-acetylneuraminate[g] + GM1[g] => CMP[g] + GD1a[g] + H+[g]
HMR_0829	GM2[c] + UDP-galactose[c] => GM1[c] + UDP[c] + H+[c]
HMR_8185	GM2[g] + UDP-galactose[g] => GM1[g] + UDP[g] + H+[g]
HMR_0827	GM3[c] + UDP-N-acetyl-D-galactosamine[c] => GM2[c] + UDP[c] + H+[c]
HMR_8190	GM3[g] + UDP-N-acetyl-D-galactosamine[g] => GM2[g] + UDP[g] + H+[g]
HMR_7327	n2m2masn[g] + UDP-N-acetylglucosamine[g] => G00020[g] + UDP[g] + H+[g]
HMR_7328	G00020[g] + UDP-N-acetylglucosamine[g] => G00021[g] + UDP[g] + H+[g]
AGLPET	1-alkyl-2-acylglycerol[c] + CDP-ethanolamine[c] => 1-alkyl-2-acylglycerophosphoethanolamine[c] + CMP[c] + H+[c]
RE3378C	1-alkyl-2-lysoglycerol-3-phosphocholine[c] + H2O[c] => choline[c] + 1-Alkyl-Sn-Glycerol 3-Phosphate[c] + H+[c]
35DSMVhep	H+[r] + NADPH[r] + O2[r] + simvastatin lactone form[r] => NADP+[r] + 3',5'-dihydrodiol-simvastatin-lactone form[r]
NAPQIhr	H+[r] + NADPH[r] + O2[r] + acetaminophen/paracetamol[r] => 2 H2O[r] + NADP+[r] + NAPQI[r]
HMR_9561	H2O[s] + retinyl palmitate[s] => palmitate[s] + retinol[s] + H+[s]
HMR_7165	cysteine[c] + [protein][c] => [protein]-L-cysteine[c] + H2O[c]
HMR_7197	serine[c] + [protein][c] => [protein]-L-serine[c] + H2O[c]
HMR_6655	4-OH-9-cis-retinal[c] + NADPH[c] + O2[c] + H+[c] => 4-oxo-9-cis-retinal[c] + 2 H2O[c] + NADP+[c]
HMR_6656	4-OH-9-cis-retinal[r] + NADPH[r] + O2[r] + H+[r] => 4-oxo-9-cis-retinal[r] + 2 H2O[r] + NADP+[r]
HMR_6702	4-hydroxy-all-trans-retinoate[c] + NADPH[c] + O2[c] + H+[c] => 4-oxo-all-trans-retinoate[c] + 2 H2O[c] + NADP+[c]
HMR_6703	4-hydroxy-all-trans-retinoate[r] + NADPH[r] + O2[r] + H+[r] => 4-oxo-all-trans-retinoate[r] + 2 H2O[r] + NADP+[r]
HMR_9553	AKG[c] + O2[c] + procollagen-L-lysine[c] => CO2[c] + procollagen-5-hydroxy-L-lysine[c] + succinate[c]
HMR_9554	3-(acyloxy)acyl group of bacterial toxin[c] + 2 H2O[c] => 3-hydroxyacyl group of bacterial toxin[c] + 2 fatty acid pool[c] + 2 H+[c]
HMR_6397	H+[c] + lipoic acid[c] + NADH[c] <=> dihydrolipoate[c] + NAD+[c]
HMR_6709	beta-carboline[c] + 2 H2O[c] <=> tryptophan[c]
HMR_1296	O2[p] + omega-COOH-dinor-LTE4-CoA[p] => 18-COOH-(16E)-dinor-LTE5-CoA[p] + H2O2[p]
HMR_1301	16e-18-oxo-18-CoA-dinor-LTE4[p] + CoA[p] + H2O[p] => acetyl-CoA[p] + omega-COOH-tetranor-LTE3-CoA[p] + 5 H+[p]
HMR_1302	H2O[p] + omega-COOH-tetranor-LTE3-CoA[p] + H+[p] => CoA[p] + omega-COOH-tetranor-LTE3[p]
HMR_1303	3 H+[p] + O2[p] + omega-COOH-tetranor-LTE3-CoA[p] => (13E)-tetranor-16-oxo-16-CoA-LTE4[p] + H2O2[p]
HMR_1092	H2O[c] + leukotriene A4[c] => 12-epi-LTB4[c]
HMR_1999	cortisol[c] + H+[c] + 2 NADPH[c] + O2[c] => 11beta-hydroxyandrost-4-ene-3,17-dione[c] + acetate[c] + 2 H2O[c] + 2 NADP+[c]
HMR_2000	cortisol[m] + H+[m] + 2 NADPH[m] + O2[m] => 11beta-hydroxyandrost-4-ene-3,17-dione[m] + acetate[m] + 2 H2O[m] + 2 NADP+[m]
HMR_2001	cortisol[r] + H+[r] + 2 NADPH[r] + O2[r] => 11beta-hydroxyandrost-4-ene-3,17-dione[r] + acetate[r] + 2 H2O[r] + 2 NADP+[r]
HMR_1319	6-oxo-prostaglandin E1[c] + H+[c] + NADH[c] <=> 6-oxo-prostaglandin F1alpha[c] + NAD+[c]
HMR_1320	6-oxo-prostaglandin F1alpha[c] + 2 H+[c] + 2 NADH[c] <=> 2 NAD+[c] + prostaglandin F1alpha[c] + H2O[c]
HMR_7600	1-alkyl-2-acylglycerol[c] + CDP-choline[c] => 1-radyl-2-acyl-sn-glycero-3-phosphocholine[c] + CMP[c] + H+[c]
HMR_7610	1-alkyl-2-acetyl-sn-glycerol[c] + CDP-choline[c] <=> 2-acetyl-1-alkyl-sn-glycero-3-phosphocholine[c] + CMP[c] + H+[c]
HMR_7615	1-radyl-2-acyl-sn-glycero-3-phosphocholine[c] + H2O[c] => 1-organyl-2-lyso-sn-glycero-3-phosphocholine[c] + fatty acid pool[c] + H+[c]
HMR_1691	3alpha,7alpha-dihydroxy-5beta-cholestan-27-al[m] + H2O[m] + NADP+[m] => 3alpha,7alpha-dihydroxy-5beta-cholestanate[m] + 2 H+[m] + NADPH[m]
HMR_1748	5beta-cholestan-3alpha,7alpha,12alpha,24(S),27-pentol[m] + NADPH[m] + O2[m] + H+[m] => 3alpha,7alpha,12alpha,24(S)-tetrahydroxy-5beta-cholestan-27-al[m] + 2 H2O[m] + NADP+[m]
HMR_1749	5beta-cholestan-3alpha,7alpha,24(S),27-tetrol[m] + NADPH[m] + O2[m] + H+[m] => 3alpha,7alpha,24(S)-trihydroxy-5beta-cholestan-27-al[m] + 2 H2O[m] + NADP+[m]
HMR_1750	3alpha,7alpha,12alpha,24(S)-tetrahydroxy-5beta-cholestan-27-al[m] + NADPH[m] + O2[m] => H2O[m] + NADP+[m] + tetraHCA[m]
HMR_1754	ATP[c] + CoA[c] + tetraHCA[c] => 25(R)TetraHCA-CoA[c] + AMP[c] + PPi[c]
HMR_1756	3,7,24THCA[c] + ATP[c] + CoA[c] => 3,7,24THCA-CoA[c] + AMP[c] + PPi[c]
HMR_2581	EPA[c] + H+[c] + NADPH[c] + 2 O2[c] => H2O[c] + NADP+[c] + PGH3[c]
HMR_2582	EPA[n] + H+[n] + NADPH[n] + 2 O2[n] => H2O[n] + NADP+[n] + PGH3[n]
HMR_0862	3-isoLM1[c] + GDP-L-fucose[c] => fuc-3-isoLM1[c] + GDP[c] + H+[c]
HMR_0897	GDP-L-fucose[c] + V3Fuc-nLc6Cer[c] => GDP[c] + V3Fuc,III3Fuc-nLc6Cer[c] + H+[c]
HMR_1388	dihomo-gamma-linolenate[c] + O2[c] => 15-HpETrE[c]
HMR_8271	GDP-L-fucose[g] + type I H glycolipid[g] => GDP[g] + glycolipid[g] + H+[g]
HMR_8287	GDP-L-fucose[g] + type II H glycolipid[g] => GDP[g] + glycolipid[g] + H+[g]
HMR_0813	galactosylgloboside[c] + GDP-L-fucose[c] => GDP[c] + globo-H[c] + H+[c]
HMR_0814	monosialylgalactosylgloboside[c] + UDP-N-acetyl-D-galactosamine[c] => UDP[c] + V3(NeuAc)2-Gb5Cer[c] + H+[c]
HMR_6783	4-hydroxyphenyllactate[c] => 4-coumarate[c] + H2O[c]
HMR_6813	dopamine-O-quinone[c] + H2O2[c] => dopaminochrome[c] + H+[c] + 2 H2O[c]
HMR_6881	3,4-dihydro-1,4-benzothiazine-3-carboxylate[c] => benzothiazine[c] + CO2[c] + H+[c]
HMR_5392	6 ATP[c] + 6 glutamate[c] + THF[c] => 6 ADP[c] + 6 Pi[c] + THF-hexaglutamate[c] + 6 H+[c]
HMR_5393	6 H2O[c] + THF-hexaglutamate[c] => 6 glutamate[c] + THF[c]
HMR_5336	2 H2O[c] + S-[2-carboxy-1-(1H-imidazol-4-yl)ethyl]glutathione[c] <=> glutamate[c] + glycine[c] + S-[2-carboxy-1-(1H-imidazol-4-yl)ethyl]-L-cysteine[c]
HMR_2443	13(S)-HPODE[c] + ferricytochrome C[c] + H+[c] <=> 13-oxy-radical-octadecadienoate[c] + ferrocytochrome C[c] + H2O[c]
HMR_2447	12,13-epoxy-9-alkoxy-(10E)-octadecenoate[c] + ferricytochrome C[c] + H2O[c] <=> 12,13-epoxy-9-hydroperoxy-(10E)-octadecenoate[c] + ferrocytochrome C[c] + H+[c]
HMR_2142	calcitetrol[c] + NADPH[c] + O2[c] + H+[c] => 24-oxo-1alpha,25-dihydroxyvitamin D3[c] + 2 H2O[c] + NADP+[c]
HMR_2143	calcitetrol[m] + NADPH[m] + O2[m] + H+[m] => 24-oxo-1alpha,25-dihydroxyvitamin D3[m] + 2 H2O[m] + NADP+[m]
HMR_7009	1-naphthol[c] + NADPH[c] + O2[c] + H+[c] => 1,4-dihydroxynaphthalene[c] + H2O[c] + NADP+[c]
HMR_9726	5-formyl-THF[c] + glutamate[c] => N-formyl-L-glutamate[c] + THF[c] + H+[c]
HMR_4763	3 FADH2[c] + hemoglobin[c] + 3 O2[c] + 2 H+[c] => biliverdin[c] + CO[c] + 3 FAD[c] + Fe3+[c] + globin[c] + 3 H2O[c]
HMR_7024	aflatoxin B1 diol[c] => aflatoxin B1 dialdehyde[c] + H+[c]
HMR_7025	aflatoxin B1 dialdehyde[c] + 2 H+[c] => 1,2,3,4-tetrahydro-alpha,7-dihydroxy-beta-(hydroxymethyl)-9-methoxy-3,4-dioxocyclopenta[c][1]benzopyran-6-propanal[c]
HMR_7027	aflatoxin B1 dialdehyde[c] + 2 H+[c] => alpha-(1,2-dihydroxyethyl)-1,2,3,4-tetrahydro-7-hydroxy-9-methoxy-3,4-dioxocyclopenta[c][1]benzopyran-6-acetaldehyde[c]
HMR_1079	arachidonate[c] + glycerol[c] + 5 H+[c] => 2 H2O[c] + noladin-ether[c]
HMR_6907	2-methoxy-6-(all-trans-decaprenyl)phenol[m] + H+[m] + NADPH[m] + O2[m] => 2-methoxy-6-all trans-decaprenyl-2-methoxy-1,4-benzoquinol[m] + H2O[m] + NADP+[m]
HMR_7032	dichloroacetyl chloride[c] + 2 NADPH[c] + O2[c] => dichloroacetate[c] + chloride[c] + H2O[c] + 2 NADP+[c]
HMR_7037	trichloroacetate[c] + NADPH[c] => dichloroacetate[c] + chloride[c] + NADP+[c]
HMR_7062	4-(n-nitrosomethylamino)-1-(3-pyridyl)-1-butanone[c] + NADPH[c] + O2[c] + H+[c] => 4-(methylnitrosamino)-1-(1-oxido-3-pyridinyl)-1-butanone[c] + NADP+[c] + H2O[c]
HMR_7067	4-(methylnitrosamino)-1-(3-pyridyl)-1-butanol[c] + NADPH[c] + O2[c] + H+[c] => 4-(methylnitrosamino)-1-(3-pyridyl-N-oxide)-1-butanol[c] + NADP+[c] + H2O[c]
HMR_7070	4-hydroxy-1-(3-pyridinyl)-1-butanone[c] + NADPH[c] + O2[c] => 3-succinoylpyridine[c] + NADP+[c] + H2O[c] + H+[c]
HMR_7072	4-oxo-1-(3-pyridyl)-1-butanone[c] + NADPH[c] + O2[c] + H+[c] => 3-succinoylpyridine[c] + NADP+[c] + H2O[c]
HMR_7074	5-(3-pyridyl)-2-hydroxytetrahydrofuran[c] + NADPH[c] + O2[c] => gamma-hydroxy-3-pyridinebutanoate[c] + NADP+[c] + H2O[c]
HMR_7076	1-(3-pyridinyl)-1,4-butanediol[c] + NADPH[c] + O2[c] => gamma-hydroxy-3-pyridinebutanoate[c] + NADP+[c] + H2O[c] + 2 H+[c]
HMR_7085	1-nitronaphthalene[c] + 3 H+[c] => 1-nitrosonaphthalene[c] + H2O[c]
HMR_7087	N-hydroxy-1-aminonaphthalene[c] + 2 H+[c] => 1-naphthylamine[c] + H2O[c]
HMR_7094	2-(S-glutathionyl)acetyl chloride[c] + H2O[c] => 2-S-glutathionyl acetate[c] + chloride[c] + H+[c]
HMR_7098	chloroacetyl chloride[c] + H2O[c] => chloroacetic acid[c] + chloride[c] + 2 H+[c]
HMR_9494	[myosin light chain]-phosphate[c] + H2O[c] => [myosin light chain][c] + Pi[c] + H+[c]
HMR_9489	[phosphorylase A][c] + 4 H2O[c] => 2 [phosphorylase B][c] + 4 Pi[c] + 4 H+[c]
HMR_9496	[protein]-L-glutamine[c] + alkylamine[c] => [protein]-N5-alkylglutamine[c] + NH4+[c]
HMR_9806	2 GSH[c] + insulin-(SS)[c] => GSSG[c] + Insulin-(SH)2[c]
HMR_9481	2 H2O[c] + kinetensin[c] => kinetensin 1-7[c] + leucine[c] + phenylalanine[c]
HMR_9502	H2O[c] + oxytocin[c] => glycinamide[c] + H+[c] + oxytocin 1-8[c]
HMR_4188	PAPS[c] + 4 NADPH[c] + 2 H+[c] => activated sulphur[c] + PAP[c] + 4 NADP+[c] + 3 H2O[c]
HMR_6400	5 H+[c] + octanoyl-[ACP][c] + 2 PAPS[c] + 2 SAM[c] + 7 NADPH[c] => 2 5-deoxyadenosine[c] + lipoyl-[ACP][c] + 2 methionine[c] + 2 PAP[c] + 7 NADP+[c] + 6 H2O[c]
HMR_6403	[protein]-N6-(octanoyl)lysine[c] + 5 H+[c] + 2 PAPS[c] + 2 SAM[c] + 7 NADPH[c] => [protein]-N6-(lipoyl)lysine[c] + 2 5-deoxyadenosine[c] + 2 methionine[c] + 2 PAP[c] + 7 NADP+[c] + 6 H2O[c]
HMR_7146	cPMP[c] + 2 PAPS[c] + 8 NADPH[c] + 7 H+[c] => molybdopterin[c] + 2 PAP[c] + 8 NADP+[c] + 8 H2O[c]
TMACMPhr	5 H+[r] + 6 NADPH[r] + O2[r] + SAM[r] + NAPQI[r] + PAPS[r] => 5 H2O[r] + 6 NADP+[r] + SAH[r] + thiomethyl-conjugate-acetaminophen[r] + PAP[r]
HMR_7672	apoC-lys_btn[c] + ATP[c] + HCO3-[c] => ADP[c] + carboxybiotin-carboxyl-carrier[c] + Pi[c] + H+[c]
HMR_7673	acetyl-CoA[c] + carboxybiotin-carboxyl-carrier[c] => apoC-lys_btn[c] + malonyl-CoA[c]
HMR_4549	6-hydroxymelatonin-sulfate[c] + H+[c] <=> 6-hydroxymelatonin[c] + sulfite[c]
HMR_8615	NADH[m] + cob(II)alamin[m] <=> cob(I)alamin[m] + NAD+[m] + H+[m]
HMR_8613	2 aquacob(III)alamin[c] + NADH[c] => 2 cob(II)alamin[c] + 2 H2O[c] + NAD+[c] + H+[c]
RE2493C	cob(II)alamin[c] + SAM[c] => SAH[c] + Methylcobalamin[c]
HMR_4842	SAM[c] => activated methyl group[c] + SAH[c]
HMR_9727	UDP-glucose[c] => UDP[c] + glycogen[c] + H+[c]
PROFVSCOAhc	4 CoA[p] + 4 NAD+[p] + NADPH[p] + 2 O2[p] + 2 H2O[p] + fluvastatin-CoA form[p] => 4 acetyl-CoA[p] + 3 H+[p] + 2 H2O2[p] + 4 NADH[p] + NADP+[p] + des-isoproylpropionic-acid-fluvastatin-CoA[p]
HMR_6393	hydroxide[c] + monodehydroascorbate[c] => dehydroascorbic acid[c] + H2O[c]
HMR_6808	dopamine[c] + H2O2[c] => dopamine-O-quinone[c] + 2 H2O[c]
RE3095L	H2O2[l] + dopamine[l] => 2 H2O[l] + dopamine-O-quinone[l]
RE3095X	H2O2[p] + dopamine[p] => 2 H2O[p] + dopamine-O-quinone[p]
r0781	2 H+[r] + 3 NADPH[r] + 3 O2[r] + lanosterol[r] => formate[r] + 4 H2O[r] + 3 NADP+[r] + 4,4-dimethyl-5alpha-cholesta-8,14,24-trien-3beta-ol[r]
HMR_4679	cysteamine[c] + O2[c] => H+[c] + hypotaurine[c]
